PEKING UNIVERSITY	北京大学
NATIONAL INSTITUTE ON DRUG ABUSE	国家药物滥用研究所
UNIVERSITY OF CALIFORNIA, BERKELEY	加州大学伯克利分校
CHINESE ACADEMY OF SCIENCES	中国科学院
BEIJING NORMAL UNIVERSITY	北京师范大学
MICROSOFT	微软
TIANJIN UNIVERSITY	天津大学
CHINA MEDICAL UNIVERSITY	中国医科大学
THIRD MILITARY MEDICAL UNIVERSITY	第三军医大学
BEIJING JISHUITAN HOSPITAL	北京积水潭医院
TSINGHUA UNIVERSITY	清华大学
MAX PLANCK SOCIETY	马克思·普朗克学会
JINAN UNIVERSITY	暨南大学
NORTHWEST UNIVERSITY	西北大学
TEMPLE UNIVERSITY	天普大学
SICHUAN UNIVERSITY	四川大学
ICAHN SCHOOL OF MEDICINE AT MOUNT SINAI	西奈山医学院
ZHEJIANG UNIVERSITY	浙江大学
OSAKA UNIVERSITY	大阪大学
RICE UNIVERSITY	赖斯大学
SUNCHON NATIONAL UNIVERSITY	顺天国立大学
KUMAMOTO UNIVERSITY	熊本大学
MASSACHUSETTS INSTITUTE OF TECHNOLOGY	麻省理工学院
SOUTH CHINA UNIVERSITY OF TECHNOLOGY	华南理工大学
DALIAN UNIVERSITY OF TECHNOLOGY	大连理工大学
NANYANG TECHNOLOGICAL UNIVERSITY	南洋理工大学
EAST CHINA NORMAL UNIVERSITY	华东师范大学
HONG KONG POLYTECHNIC UNIVERSITY	香港理工大学
HARVARD UNIVERSITY	哈佛大学
UNIVERSITY OF CALIFORNIA, DAVIS	加州大学戴维斯分校
BEIJING INSTITUTE OF GENOMICS	北京基因组学研究所
SOUTHWEST JIAOTONG UNIVERSITY	西南交通大学
JILIN UNIVERSITY	吉林大学
NATIONAL INSTITUTES OF HEALTH	国立卫生研究院
UNIVERSITY OF QUEENSLAND	昆士兰大学
JOHNS HOPKINS UNIVERSITY	约翰霍普金斯大学
NORTHWESTERN POLYTECHNICAL UNIVERSITY	西北工业大学
ARGONNE NATIONAL LABORATORY	阿贡国家实验室
NATIONAL UNIVERSITY OF SINGAPORE	新加坡国立大学
PENNSYLVANIA STATE UNIVERSITY	宾夕法尼亚州立大学
CHINA AGRICULTURAL UNIVERSITY	中国农业大学
AUSTRALIAN NATIONAL UNIVERSITY	澳大利亚国立大学
HOFFMANN-LA ROCHE	霍夫曼-罗氏
BEIJING JIAOTONG UNIVERSITY	北京交通大学
BEIJING UNIVERSITY OF POSTS AND TELECOMMUNICATIONS	北京邮电大学
INTEL	英特尔
CHINA UNIVERSITY OF GEOSCIENCES	中国地质大学
FOXCONN	富士康
UNIVERSITY OF BATH	巴斯大学
BRANDEIS UNIVERSITY	布兰来斯大学
BOSTON UNIVERSITY	波士顿大学
XIDIAN UNIVERSITY	西安电子科技大学
AGRICULTURAL RESEARCH SERVICE	农业研究服务
KATHOLIEKE UNIVERSITEIT LEUVEN	KATHOLIEKE 大学鲁汶
UNIVERSITY OF MICHIGAN	密歇根大学
UNITED STATES MILITARY ACADEMY	美国军事学院
FUDAN UNIVERSITY	复旦大学
CITY UNIVERSITY OF HONG KONG	香港城市大学
CENTRAL SOUTH UNIVERSITY	中南大学
UNIVERSITY OF WISCONSIN-MADISON	威斯康星大学麦迪逊分校
CHARTERED SEMICONDUCTOR MANUFACTURING	特许半导体制造
TEXAS A&M UNIVERSITY	德克萨斯A&M大学
XI'AN JIAOTONG UNIVERSITY	西安交通大学
CHANG'AN UNIVERSITY	长安大学
YALE UNIVERSITY	耶鲁大学
DALIAN INSTITUTE OF CHEMICAL PHYSICS	大连化学物理研究所
SUN YAT-SEN UNIVERSITY	中山大学
JOHNS HOPKINS UNIVERSITY SCHOOL OF MEDICINE	约翰霍普金斯大学医学院
AFFYMETRIX	AFFYMETRIX
COLORADO STATE UNIVERSITY	科罗拉多州立大学
UNIVERSITY COLLEGE LONDON	伦敦大学学院
GEORGETOWN UNIVERSITY MEDICAL CENTER	乔治敦大学医学中心
UNIVERSITY OF LEEDS	利兹大学
TONGJI UNIVERSITY	同济大学
BOSTON MEDICAL CENTER	波士顿医疗中心
UNIVERSITY OF BONN	波恩大学
GEORGIA REGENTS UNIVERSITY	乔治亚摄政大学
NATIONAL CHENG KUNG UNIVERSITY	国立诚武大学
G. D. SEARLE & COMPANY	塞尔公司
OHIO STATE UNIVERSITY	俄亥俄州立大学
UNIVERSITY OF CENTRAL FLORIDA	中佛罗里达大学
UNIVERSITY OF WESTERN SYDNEY	西悉尼大学
UNIVERSITY OF WOLVERHAMPTON	胡弗汉顿大学
UNIVERSITY OF ABERDEEN	阿伯丁大学
UNIVERSITY OF DELAWARE	特拉华大学
MITSUBISHI ELECTRIC RESEARCH LABORATORIES	三菱电气研究实验室
HEFEI UNIVERSITY OF TECHNOLOGY	合肥工业大学
SCRIPPS RESEARCH INSTITUTE	斯克利普斯研究所
ACADEMIA SINICA	中央研究院
EDGE HILL UNIVERSITY	边山大学
UNIVERSITY OF VIRGINIA	弗吉尼亚大学
PRINCETON UNIVERSITY	普林斯顿大学
UNIVERSITY OF SOUTHERN MISSISSIPPI	南密西西比大学
ARIZONA STATE UNIVERSITY	亚利桑那州立大学
CARNEGIE MELLON UNIVERSITY	卡内基梅隆大学
UNIVERSITY OF UTAH	犹他大学
BEIHANG UNIVERSITY	北京航空航天大学
FOOD AND DRUG ADMINISTRATION	食品药品监督管理局
GUANGXI MEDICAL UNIVERSITY	广西医科大学
WUHAN UNIVERSITY	武汉大学
HUAZHONG UNIVERSITY OF SCIENCE AND TECHNOLOGY	华中科技大学
CENTERS FOR DISEASE CONTROL AND PREVENTION	疾病控制和预防中心
GUANGZHOU MEDICAL UNIVERSITY	广州医科大学
UNIVERSITY OF BIRMINGHAM	伯明翰大学
CHILDREN'S HOSPITAL OF PHILADELPHIA	费城儿童医院
OHIO UNIVERSITY	俄亥俄州大学
UNIVERSITY OF ARKANSAS FOR MEDICAL SCIENCES	阿肯色大学医学研究所
NANJING UNIVERSITY OF INFORMATION SCIENCE AND TECHNOLOGY	南京信息科技大学
UNIVERSITY OF NORTH CAROLINA AT CHAPEL HILL	北卡罗来纳大学教堂山分校
UNIVERSITY OF MINNESOTA	明尼苏达大学
SHANGHAI UNIVERSITY	上海大学
NORTHWEST A&F UNIVERSITY	西北大学
MACQUARIE UNIVERSITY	麦考瑞大学
BELL LABS	贝尔实验室
UNIVERSITY OF OTAGO	奥塔哥大学
UNIVERSITY OF ELECTRONIC SCIENCE AND TECHNOLOGY OF CHINA	中国电子科技大学
CHONGQING MEDICAL UNIVERSITY	重庆医科大学
WILLAMETTE UNIVERSITY	威拉米特大学
HEBREW UNIVERSITY OF JERUSALEM	耶路撒冷希伯来大学
NANJING UNIVERSITY OF AERONAUTICS AND ASTRONAUTICS	南京航空航天大学
NANJING UNIVERSITY OF SCIENCE AND TECHNOLOGY	南京理工大学
CHINESE MINISTRY OF PUBLIC SECURITY	中国公安部
NORTH CHINA ELECTRIC POWER UNIVERSITY	华北电力大学
UNIVERSITY OF LIVERPOOL	利物浦大学
LUXTERA	LUXTERA
HARBIN VETERINARY RESEARCH INSTITUTE	中国农业科学院哈尔滨兽医研究所
CHINESE ACADEMY OF TROPICAL AGRICULTURAL SCIENCES	中国热带农业科学院
CITY UNIVERSITY OF NEW YORK	纽约城市大学
PORTLAND STATE UNIVERSITY	波特兰州立大学
UPPSALA UNIVERSITY	乌普萨拉大学
FRED HUTCHINSON CANCER RESEARCH CENTER	弗雷德·哈钦森癌症研究中心
THE CHINESE UNIVERSITY OF HONG KONG	香港中文大学
UNIVERSITY OF WASHINGTON	华盛顿大学
COLUMBIA UNIVERSITY	哥伦比亚大学
NORTHSHORE UNIVERSITY HEALTHSYSTEM	北岸大学健康系统
BIRKBECK, UNIVERSITY OF LONDON	伯克贝克, 伦敦大学
ACADEMY OF MEDICAL SCIENCES, UNITED KINGDOM	英国医学科学院
CARRIER CORPORATION	开利公司
AMGEN	安进
UNIVERSITY OF NOTRE DAME	圣母大学
UNIVERSITY OF NORTH CAROLINA AT CHARLOTTE	北卡罗来纳大学夏洛特分校
CENTER FOR ENVIRONMENTAL HEALTH	环境健康中心
UNIVERSITY OF SHEFFIELD	谢菲尔德大学
WUHAN UNIVERSITY OF TECHNOLOGY	武汉理工大学
OREGON HEALTH & SCIENCE UNIVERSITY	俄勒冈健康与科学大学
SHANGHAITECH UNIVERSITY	上海科技大学
NANJING UNIVERSITY OF POSTS AND TELECOMMUNICATIONS	南京邮电大学
UNIVERSITY OF DUNDEE	邓迪大学
CASE WESTERN RESERVE UNIVERSITY	凯斯西储大学
GENERAL MOTORS	通用汽车公司
WASHINGTON UNIVERSITY IN ST. LOUIS	圣路易斯华盛顿大学
MERCK & CO.	默克公司
ZHENGZHOU UNIVERSITY	郑州大学
POLAR RESEARCH INSTITUTE OF CHINA	中国极地研究院
CARLETON UNIVERSITY	卡尔顿大学
YANSHAN UNIVERSITY	燕山大学
PEKING UNION MEDICAL COLLEGE HOSPITAL	北京协和医科大学医院
SOUTHERN MEDICAL UNIVERSITY	南方医科大学
AGENCY FOR SCIENCE, TECHNOLOGY AND RESEARCH	科学、技术和研究机构
HUMAN GENOME SCIENCES	人类基因组科学
ROCKWELL COLLINS	罗克韦尔柯林斯
WELLCOME TRUST SANGER INSTITUTE	康威信托研究所
LAVAL UNIVERSITY	拉伐尔大学
QUALCOMM	高通
CITY OF HOPE NATIONAL MEDICAL CENTER	希望之城国家医疗中心
PLEXXIKON	PLEXXIKON
STONY BROOK UNIVERSITY	石溪大学
BENAROYA RESEARCH INSTITUTE	贝纳罗亚研究所
SCHERING-PLOUGH	先灵葆雅公司
UNIVERSITY OF HOUSTON	休斯顿大学
CHALMERS UNIVERSITY OF TECHNOLOGY	查尔姆斯理工大学
ZHONGNAN UNIVERSITY OF ECONOMICS AND LAW	中南财经政法大学
SOUTHWEST UNIVERSITY	西南大学
UNITED STATES DEPARTMENT OF ENERGY	美国能源部
UNIVERSITY OF EAST ANGLIA	东英吉利大学
APPLE INC.	苹果公司
ICF INTERNATIONAL	ICF 国际
UNIVERSITY OF SOUTH FLORIDA	南佛罗里达大学
FLORIDA ATLANTIC UNIVERSITY	佛罗里达大西洋大学
RMIT UNIVERSITY	皇家墨尔本理工大学
UNIVERSITY OF HONG KONG	香港大学
GUILIN UNIVERSITY OF TECHNOLOGY	桂林理工大学
FUZHOU UNIVERSITY	福州大学
STRUCTURAL GENOMICS CONSORTIUM	结构基因组联盟
SOUTH CHINA NORMAL UNIVERSITY	华南师范大学
UNIVERSITY OF S?O PAULO	圣保罗大学
UNIVERSITY OF NEVADA, LAS VEGAS	内华达州大学拉斯维加斯分校
FLORIDA STATE UNIVERSITY	佛罗里达州立大学
UNIVERSITY OF CALGARY	卡尔加里大学
NOKIA	诺基亚
NANJING MEDICAL UNIVERSITY	南京医科大学
LIFE SCIENCES INSTITUTE	生命科学研究所
NATIONAL CHUNG CHENG UNIVERSITY	国立中正大学
SHANTOU UNIVERSITY	汕头大学
DALIAN MARITIME UNIVERSITY	大连海事大学
HENAN UNIVERSITY OF SCIENCE AND TECHNOLOGY	河南科技大学
MIDDLE TENNESSEE STATE UNIVERSITY	中田纳西州立大学
UNIVERSITY OF WOLLONGONG	卧龙岗大学
SILICON LABS	硅实验室
HASSO PLATTNER INSTITUTE	HASSO 普拉特纳研究所
UNIVERSITY OF BRITISH COLUMBIA	不列颠哥伦比亚大学
XIANGTAN UNIVERSITY	湘潭大学
UNIVERSITY OF TEXAS AT EL PASO	德克萨斯大学埃尔帕索分校
XEROX	施乐
UNIVERSITY OF TECHNOLOGY, SYDNEY	悉尼理工大学
UNIVERSITY OF NEBRASKA–LINCOLN	内布拉斯加大学林肯分校
FOX CHASE CANCER CENTER	福克斯蔡斯癌症中心
GUANGDONG UNIVERSITY OF TECHNOLOGY	广东工业大学
FUDAN UNIVERSITY SHANGHAI MEDICAL COLLEGE	复旦大学上海医科大学
GENOME INSTITUTE OF SINGAPORE	新加坡基因组研究所
BEIJING UNIVERSITY OF CHEMICAL TECHNOLOGY	北京化工大学
IOWA STATE UNIVERSITY	爱荷华州立大学
RENMIN UNIVERSITY OF CHINA	中国人民大学
UNIVERSITY OF TEXAS–PAN AMERICAN	德克萨斯大学潘美分校
EAST CHINA UNIVERSITY OF SCIENCE AND TECHNOLOGY	华东理工大学
CHINA METEOROLOGICAL ADMINISTRATION	中国气象总局
J. CRAIG VENTER INSTITUTE	克雷格·文特尔研究所
SCIENCE APPLICATIONS INTERNATIONAL CORPORATION	科学应用国际公司
HUNAN UNIVERSITY	湖南大学
RUTGERS UNIVERSITY	罗格斯大学
CHINA UNIVERSITY OF PETROLEUM	中国石油大学
BEIJING FORESTRY UNIVERSITY	北京林业大学
SICHUAN UNIVERSITY OF SCIENCE AND ENGINEERING	四川理工大学
MIDDLESEX UNIVERSITY	米德尔塞克斯大学
UNIVERSITY OF CALIFORNIA, SANTA BARBARA	加州大学圣巴巴拉分校
INTERNATIONAL RICE RESEARCH INSTITUTE	国际稻米研究所
SHANDONG UNIVERSITY	山东大学
NANCHANG HANGKONG UNIVERSITY	南昌航空大学
HONG KONG UNIVERSITY OF SCIENCE AND TECHNOLOGY	香港科技大学
NANKAI UNIVERSITY	南开大学
UNIVERSITY OF G?TTINGEN	G 大学？TTINGEN
HARBIN INSTITUTE OF TECHNOLOGY	哈尔滨工业学院
INTERNATIONAL BUSINESS SCHOOL	国际商学院
COLLEGE OF MANAGEMENT AND ECONOMICS	管理与经济学院
BLOOMBERG L.P.	彭博
UNIVERSITY OF ARIZONA	亚利桑那大学
STANFORD UNIVERSITY	斯坦福大学
UNIVERSITY OF MELBOURNE	墨尔本大学
KANSAS STATE UNIVERSITY	堪萨斯州立大学
UNIVERSITY OF TORONTO	多伦多大学
RESEARCH TRIANGLE PARK	三角研究园
CHUNG HUA UNIVERSITY	中华大学
NANJING UNIVERSITY OF TECHNOLOGY	南京工业大学
UNIVERSITY OF TEXAS AT AUSTIN	德克萨斯大学奥斯汀分校
THERMO FISHER SCIENTIFIC	赛默飞世尔科技
UNIVERSITY OF SCIENCE AND TECHNOLOGY OF CHINA	中国科学技术大学
UNIVERSITY OF CAMBRIDGE	剑桥大学
CANCER INSTITUTE	癌症研究所
OCEAN UNIVERSITY OF CHINA	中国海洋大学
CHINA UNIVERSITY OF MINING AND TECHNOLOGY	中国矿业大学
DUKE UNIVERSITY	杜克大学
THOMAS JEFFERSON UNIVERSITY	托马斯·杰斐逊大学
CHINA-JAPAN FRIENDSHIP HOSPITAL	中日友好医院
NORTHWESTERN UNIVERSITY	西北大学
NATIONAL TAIWAN UNIVERSITY	国立台湾大学
NANJING UNIVERSITY OF FINANCE AND ECONOMICS	南京财经大学
SHANGHAI UNIVERSITY OF FINANCE AND ECONOMICS	上海财经大学
NANJING UNIVERSITY	南京大学
JOHNSON & JOHNSON	约翰逊和约翰逊
MOTOROLA	摩托罗拉
HEWLETT-PACKARD	惠普
TEXAS CENTER FOR SUPERCONDUCTIVITY	德州超导中心
UNIVERSITY OF ARKANSAS	阿肯色州大学
UNIVERSITY OF TEXAS MD ANDERSON CANCER CENTER	德克萨斯大学安德森癌症中心
UNIVERSITY OF CALIFORNIA, SAN FRANCISCO	加州大学旧金山分校
UNIVERSITY OF ILLINOIS AT CHICAGO	伊利诺伊大学芝加哥分校
NAGOYA UNIVERSITY	名古屋大学
HOHAI UNIVERSITY	河海大学
UNIVERSITY OF TEXAS AT ARLINGTON	德克萨斯大学阿林顿分校
TULANE UNIVERSITY	杜兰大学
UNIVERSITY OF MALAYA	马来亚大学
JIANGNAN UNIVERSITY	江南大学
NATIONAL CENTER FOR ELECTRON MICROSCOPY	国家电子显微镜中心
UNIVERSITY OF CALIFORNIA, SANTA CRUZ	加州大学圣克鲁斯分校
UNIVERSITY OF TEXAS SOUTHWESTERN MEDICAL CENTER	德克萨斯大学西南医学中心
LAWRENCE BERKELEY NATIONAL LABORATORY	劳伦斯伯克利国家实验室
ETH ZURICH	苏黎世理工学院
UNIVERSITY OF SOUTHERN CALIFORNIA	南加州大学
LABORATORY OF MOLECULAR BIOLOGY	分子生物学实验室
UNIVERSITY OF TSUKUBA	筑波大学
JAPAN ATOMIC ENERGY RESEARCH INSTITUTE	日本原子能研究院
CHINESE CENTER FOR DISEASE CONTROL AND PREVENTION	中国疾病预防控制中心
BEIJING UNIVERSITY OF TECHNOLOGY	北京工业大学
ORANGE S.A.	ORANGE S.A.
UNIVERSITY OF MIAMI	迈阿密大学
HELSINKI UNIVERSITY CENTRAL HOSPITAL	赫尔辛基大学中央医院
GEORGIA STATE UNIVERSITY	佐治亚州立大学
HUAZHONG AGRICULTURAL UNIVERSITY	华中农业大学
UNIVERSITY OF WISCONSIN–MILWAUKEE	威斯康星大学密尔沃基分校
CHONGQING UNIVERSITY	重庆大学
UNIVERSITY OF SCIENCE AND TECHNOLOGY, SANA'A	萨那科技大学
QUFU NORMAL UNIVERSITY	曲阜师范大学
MCGILL UNIVERSITY	麦吉尔大学
NATIONAL RESEARCH COUNCIL	国家研究委员会
UNIVERSITY OF NORTH TEXAS	北德克萨斯大学
UNIVERSITY OF CHICAGO	芝加哥大学
UNIVERSITY OF NEW SOUTH WALES	新南威尔士大学
UNIVERSITY OF AIZU	会津大学
NEW YORK UNIVERSITY	纽约大学
WENZHOU MEDICAL COLLEGE	温州医科大学
UNIVERSITY OF PITTSBURGH	匹兹堡大学
KOHLER COMPANY	科勒公司
STATE UNIVERSITY OF NEW YORK SYSTEM	纽约州立大学系统
BEIJING INSTITUTE OF TECHNOLOGY	北京理工大学
HARBIN ENGINEERING UNIVERSITY	哈尔滨工业大学
GEORGIA INSTITUTE OF TECHNOLOGY	佐治亚理工学院
HUAWEI	华为
TIANJIN NORMAL UNIVERSITY	天津师范大学
NATIONAL CENTER FOR IMMUNIZATION AND RESPIRATORY DISEASES	国家免疫和呼吸系统疾病中心
UNIVERSITY OF CALIFORNIA, RIVERSIDE	加利福尼亚大学河滨分校
CORNELL UNIVERSITY	康奈尔大学
SECOND MILITARY MEDICAL UNIVERSITY	第二军医大学
LIVERPOOL JOHN MOORES UNIVERSITY	利物浦约翰摩尔大学
FOURTH MILITARY MEDICAL UNIVERSITY	第四军医大学
UNIVERSITY OF CALIFORNIA, LOS ANGELES	加州大学洛杉矶分校
SHANXI UNIVERSITY	山西大学
ILLINOIS INSTITUTE OF TECHNOLOGY	伊利诺伊理工大学
BROOKHAVEN NATIONAL LABORATORY	布鲁克黑文国家实验室
HARBIN MEDICAL UNIVERSITY	哈尔滨医科大学
CENTER FOR ADVANCED MATERIALS	先进材料中心
LAWRENCE LIVERMORE NATIONAL LABORATORY	劳伦斯国家实验室
XIAMEN UNIVERSITY	厦门大学
NANCHANG UNIVERSITY	南昌大学
PFIZER	辉瑞
NORTH SHORE UNIVERSITY HOSPITAL	北岸大学医院
SICHUAN AGRICULTURAL UNIVERSITY	四川农业大学
MINISTRY OF EDUCATION	教育部
CHARLES STURT UNIVERSITY	查尔斯斯特大学
GEORGE MASON UNIVERSITY	乔治梅森大学
GUIZHOU UNIVERSITY	贵州大学
GOOGLE	谷歌
YUNNAN UNIVERSITY	云南大学
NORTHWEST NORMAL UNIVERSITY	西北师范大学
FRAUNHOFER SOCIETY	弗劳恩霍夫协会
NATIONAL INSTITUTE OF INFORMATICS	国立信息学研究所
UNIVERSITY OF NEW BRUNSWICK	新不伦瑞克大学
CHINESE MINISTRY OF EDUCATION	中国教育部
CARDIFF UNIVERSITY	加的夫大学
CALIFORNIA INSTITUTE OF TECHNOLOGY	加利福尼亚理工学院
STOCKHOLM UNIVERSITY	斯德哥尔摩大学
FERMILAB	FERMILAB
TEXAS MEDICAL CENTER	德州医疗中心
VANDERBILT UNIVERSITY	范德比尔特大学
UNIVERSITY OF MARYLAND, COLLEGE PARK	马里兰大学公园
AMES RESEARCH CENTER	艾姆斯研究中心
UNIVERSITY OF KANSAS	堪萨斯大学
UNIVERSITY OF ALBERTA	阿尔伯塔大学
SHENYANG UNIVERSITY OF TECHNOLOGY	沈阳工业大学
UNIVERSITY OF EDINBURGH	爱丁堡大学
UNIVERSITY OF ONTARIO INSTITUTE OF TECHNOLOGY	安大略省大学理工学院
PURDUE UNIVERSITY	普渡大学
UNIVERSITY OF AKRON	阿克伦大学
PACIFIC NORTHWEST NATIONAL LABORATORY	太平洋西北国家实验室
UNIVERSITY AT BUFFALO	布法罗大学
SAINT LOUIS UNIVERSITY	圣路易斯大学
CELERA CORPORATION	塞雷拉基因组公司
BAYLOR COLLEGE OF MEDICINE	贝勒医学院
MAYO CLINIC	梅奥诊所
UNIVERSITY OF CINCINNATI	辛辛那提大学
UNIVERSITY OF SCIENCE AND TECHNOLOGY BEIJING	北京科技大学
UNIVERSITY OF VIRGINIA HEALTH SYSTEM	弗吉尼亚大学卫生系统
NINGBO UNIVERSITY	宁波大学
UNIVERSITY OF IOWA	爱荷华州大学
COMMONWEALTH SCIENTIFIC AND INDUSTRIAL RESEARCH ORGANISATION	英联邦科学和工业研究组织
COOPERATIVE RESEARCH CENTRE	合作研究中心
DURHAM UNIVERSITY	达勒姆大学
LOUGHBOROUGH UNIVERSITY	拉夫堡大学
ATOMIC ENERGY COUNCIL	原子能理事会
ZHEJIANG SCI-TECH UNIVERSITY	浙江理工大学
MICHIGAN STATE UNIVERSITY	密歇根州立大学
BROWN UNIVERSITY	布朗大学
ACADEMY OF MILITARY MEDICAL SCIENCES	军事医学科学院
MERCK KGAA	默克股份
UNIVERSITY OF PENNSYLVANIA	宾夕法尼亚大学
MCGOVERN INSTITUTE FOR BRAIN RESEARCH	麦戈文大脑研究研究所
TOTTORI UNIVERSITY	鸟取大学
TOYOTA	丰田
UNIVERSITY OF CONNECTICUT	康涅狄格大学
FRENCH INSTITUTE OF HEALTH AND MEDICAL RESEARCH	法国卫生与医学研究所
ULSTER UNIVERSITY	阿尔斯特大学
NOVARTIS	诺华
NEWCASTLE UNIVERSITY	纽卡斯尔大学
CENTER FOR NANOSCIENCE	纳米中心
UNIVERSITY OF INNSBRUCK	因斯布鲁克大学
UNIVERSITY OF NEBRASKA MEDICAL CENTER	内布拉斯加州大学医学中心
NIELS BOHR INSTITUTE	玻尔研究所
ILLUMINA	ILLUMINA
APPLIED BIOSYSTEMS	应用生物病理
NORTEL	NORTEL
XISHUANGBANNA TROPICAL BOTANICAL GARDEN	西双版纳热带植物园
HIROSHIMA UNIVERSITY	广岛大学
ONYX PHARMACEUTICALS	玛瑙制药
UNIVERSITY OF MISSISSIPPI	密西西比大学
ANHUI MEDICAL UNIVERSITY	安徽医科大学
UNIVERSITY OF MARYLAND BIOTECHNOLOGY INSTITUTE	马里兰大学生物技术研究所
BRISTOL-MYERS SQUIBB	布里斯托尔-迈尔斯宝
SYNGENTA	先正达
UNIVERSITY OF NEW MEXICO	新墨西哥大学
CENTRE NATIONAL DE LA RECHERCHE SCIENTIFIQUE	中心国家 DE 研究所科学研究
UNIVERSITY OF GUELPH	圭尔夫大学
ALBANY MEDICAL COLLEGE	奥尔巴尼医科大学
UNIVERSITY OF CENTRAL ARKANSAS	阿肯色州中部大学
LEONARD DAVIS INSTITUTE OF HEALTH ECONOMICS	伦纳德戴维斯健康经济研究所
LOUISIANA STATE UNIVERSITY	路易斯安那州立大学
UNIVERSITY OF KENTUCKY	肯塔基大学
NORTHEAST NORMAL UNIVERSITY	东北师范大学
YANGZHOU UNIVERSITY	扬州大学
MICHIGAN TECHNOLOGICAL UNIVERSITY	密歇根理工大学
TOHOKU UNIVERSITY	东北大学
MISSOURI UNIVERSITY OF SCIENCE AND TECHNOLOGY	密苏里州科技大学
SOUTH DAKOTA SCHOOL OF MINES AND TECHNOLOGY	南达科他州矿业和技术学院
HOWARD HUGHES MEDICAL INSTITUTE	霍华德休斯医学研究所
WASHINGTON STATE UNIVERSITY SPOKANE	华盛顿州立大学斯波坎
SRI INTERNATIONAL	斯里兰卡国际
UNIVERSITY OF SURREY	萨里大学
SOOCHOW UNIVERSITY	苏州大学
AKITA UNIVERSITY	秋田大学
FRENCH INSTITUTE FOR RESEARCH IN COMPUTER SCIENCE AND AUTOMATION	法国计算机科学与自动化研究所
UNIVERSITY OF SOUTH CAROLINA	南卡罗来纳大学
DELFT UNIVERSITY OF TECHNOLOGY	代尔夫特理工大学
NORTHEASTERN UNIVERSITY	东北大学
HAMMERSMITH HOSPITAL	哈默史密斯医院
ZHEJIANG UNIVERSITY OF TECHNOLOGY	浙江工业大学
LOS ALAMOS NATIONAL LABORATORY	洛斯阿拉莫斯国家实验室
QINGDAO UNIVERSITY	青岛大学
UNIVERSITY OF MEDICINE AND DENTISTRY OF NEW JERSEY	新泽西州医学与牙科大学
UNIVERSITY OF MASSACHUSETTS MEDICAL SCHOOL	麻省大学医学院
NEW YORK MEDICAL COLLEGE	纽约医科大学
UNIVERSITY OF MASSACHUSETTS LOWELL	马萨诸塞州大学洛厄尔分校
DONGHUA UNIVERSITY	东华大学
THE ROSLIN INSTITUTE	罗林学院
PENN STATE COLLEGE OF INFORMATION SCIENCES AND TECHNOLOGY	宾夕法尼亚州立信息科学与技术学院
UNIVERSITY OF OKLAHOMA	俄克拉何马州大学
WORLD BANK	世界银行
SOUTH CENTRAL UNIVERSITY FOR NATIONALITIES	中南民族大学
OKAYAMA UNIVERSITY	冈山大学
CONNECTICUT AGRICULTURAL EXPERIMENT STATION	康涅狄格州农业试验站
UNIVERSITY OF WARWICK	华威大学
ELI LILLY AND COMPANY	礼来公司
XI'AN UNIVERSITY OF ARCHITECTURE AND TECHNOLOGY	西安建筑科技大学
JANSSEN PHARMACEUTICA	杨森药学
NANJING AGRICULTURAL UNIVERSITY	南京农业大学
CHINA PHARMACEUTICAL UNIVERSITY	中国药科大学
INDIANA UNIVERSITY – PURDUE UNIVERSITY INDIANAPOLIS	印第安纳大学-普渡大学印第安纳波利斯联合分校
MCMASTER UNIVERSITY	麦克马斯特大学
GUNMA UNIVERSITY	群马大学
UNIVERSITY OF ROCHESTER	罗切斯特大学
SYRACUSE UNIVERSITY	雪城大学
THOMAS JEFFERSON NATIONAL ACCELERATOR FACILITY	托马斯·杰斐逊国家加速器设施
SHENYANG AEROSPACE UNIVERSITY	沈阳航空航天大学
MILLENNIUM PHARMACEUTICALS	千禧医药
CHINA WEST NORMAL UNIVERSITY	中国西部师范大学
KANSAI UNIVERSITY	关西大学
LI KA SHING FACULTY OF MEDICINE, UNIVERSITY OF HONG KONG	香港大学李嘉盛医学院
UNIVERSITY OF SYDNEY	悉尼大学
UNIVERSITY OF WESTERN AUSTRALIA	西澳大利亚大学
HRL LABORATORIES	HRL实验室
UNIVERSITY OF LAUSANNE	洛桑大学
KYOTO UNIVERSITY	京都大学
KARLSRUHE INSTITUTE OF TECHNOLOGY	卡尔斯鲁厄技术学院
UNIVERSITY OF NOTTINGHAM	诺丁汉大学
UNIVERSITY OF PORTSMOUTH	朴茨茅斯大学
CENTER FOR BIOLOGICS EVALUATION AND RESEARCH	生物制剂评估与研究中心
NATIONAL HEALTH AND FAMILY PLANNING COMMISSION	国家卫生与计划生育委员会
SOUTHWESTERN UNIVERSITY OF FINANCE AND ECONOMICS	西南财经大学
UNIVERSITY OF NEBRASKA OMAHA	内布拉斯加大学奥马哈分校
TECHNION – ISRAEL INSTITUTE OF TECHNOLOGY	以色列理工学院
SIMON FRASER UNIVERSITY	西蒙弗雷泽大学
SHENYANG INSTITUTE OF AUTOMATION	沈阳自动化研究所
QUEEN'S UNIVERSITY BELFAST	贝尔法斯特皇后大学
CENTER FOR CELL AND GENE THERAPY	细胞与基因治疗中心
CHINESE NATIONAL HUMAN GENOME CENTER	中国国家人类基因组中心
WENZHOU UNIVERSITY	温州大学
UNIVERSITY OF AGRICULTURE, FAISALABAD	费萨拉巴德农业大学
SHAANXI NORMAL UNIVERSITY	陕西师范大学
CHANGCHUN UNIVERSITY OF SCIENCE AND TECHNOLOGY	长春理工大学
CHIA NAN UNIVERSITY OF PHARMACY AND SCIENCE	嘉南药学与科学大学
UNIVERSITY OF WESTMINSTER	西敏大学
NITTO DENKO	日东电工
PLYMOUTH UNIVERSITY	普利茅斯大学
PEKING UNION MEDICAL COLLEGE	北京协和医学院
UNIVERSITY OF BRISTOL	布里斯托尔大学
MONASH UNIVERSITY	莫纳什大学
OAK RIDGE NATIONAL LABORATORY	橡树岭国家实验室
UNIVERSITY OF RENNES	雷恩大学
UMICORE	优美科
SINOPEC	中石化
CIVIL AVIATION AUTHORITY OF SINGAPORE	新加坡民航局
WAKE FOREST UNIVERSITY	维克森林大学
DREXEL UNIVERSITY	德雷克塞尔大学
COLLEGE OF BUSINESS ADMINISTRATION	工商管理学院
UNIVERSITY OF OSLO	奥斯陆大学
NATIONAL UNIVERSITY OF DEFENSE TECHNOLOGY	国防科学技术大学
CAPITAL MEDICAL UNIVERSITY	首都医科大学
IMPERIAL COLLEGE LONDON	伦敦帝国学院
YANGTZE UNIVERSITY	长江大学
TIANJIN MEDICAL UNIVERSITY GENERAL HOSPITAL	天津医科大学总医院
LSU HEALTH SCIENCES CENTER NEW ORLEANS	新奥尔良 LSU 健康科学中心
UNIVERSITY OF FLORIDA	佛罗里达大学
TAIYUAN UNIVERSITY OF TECHNOLOGY	太原理工大学
HOKKAIDO UNIVERSITY	北海道大学
QINGDAO UNIVERSITY OF SCIENCE AND TECHNOLOGY	青岛科技大学
AT&T	AT&T
XUZHOU MEDICAL COLLEGE	徐州医学院
DALIAN NAVAL ACADEMY	大连海军学院
UNIVERSITY OF MANCHESTER	曼彻斯特大学
SHANDONG AGRICULTURAL UNIVERSITY	山东农业大学
COLLEGE OF HORTICULTURE	园艺学院
HUNAN UNIVERSITY OF SCIENCE AND TECHNOLOGY	湖南科技大学
HENAN AGRICULTURAL UNIVERSITY	河南农业大学
EHIME UNIVERSITY	爱媛大学
CENTRAL SOUTH UNIVERSITY FORESTRY AND TECHNOLOGY	中南林业科技大学
GUANGXI UNIVERSITY	广西大学
HAINAN UNIVERSITY	海南大学
CHONGQING UNIVERSITY OF POSTS AND TELECOMMUNICATIONS	重庆邮电大学
KUNMING UNIVERSITY OF SCIENCE AND TECHNOLOGY	昆明理工大学
EAST CHINA JIAOTONG UNIVERSITY	华东交通大学
UNIVERSITY OF SOUTHAMPTON	南安普敦大学
UNIVERSAL DISPLAY CORPORATION	通用显示公司
UNIVERSITY OF ZURICH	苏黎世大学
GERON CORPORATION	杰龙生物医药公司
HUBEI UNIVERSITY	湖北大学
UNIVERSITY OF ESSEX	埃塞克斯大学
UNIVERSITY OF PARIS	巴黎大学
DALHOUSIE UNIVERSITY	豪斯大学
YUAN ZE UNIVERSITY	元泽大学
WASHINGTON STATE UNIVERSITY	华盛顿州立大学
NORTH DAKOTA STATE UNIVERSITY	北达科他州立大学
NANJING NORMAL UNIVERSITY	南京师范大学
LAKEHEAD UNIVERSITY	湖首大学
HONDA	本田
NORTHERN ILLINOIS UNIVERSITY	北伊利诺伊大学
CERN	欧洲核子研究组织
UCL INSTITUTE OF CHILD HEALTH	伦敦大学儿童健康学院
UNIVERSITY OF COLORADO BOULDER	科罗拉多大学博尔德分校
UNIVERSITY OF WATERLOO	滑铁卢大学
CRANFIELD UNIVERSITY	克兰菲尔德大学
CLEVELAND CLINIC	克利夫兰诊所
UNIVERSITY OF MARYLAND, BALTIMORE	马里兰大学巴尔的摩分校
MINZU UNIVERSITY OF CHINA	中国民族大学
DUPONT	杜邦
FORDHAM UNIVERSITY	福特汉姆大学
SHANGHAI MARITIME UNIVERSITY	上海海事大学
BETH ISRAEL DEACONESS MEDICAL CENTER	贝丝以色列女执事医疗中心
ST. JUDE CHILDREN'S RESEARCH HOSPITAL	圣裘德儿童研究医院
INTERNATIONAL FOOD POLICY RESEARCH INSTITUTE	国际食品政策研究所
QUEEN MARY UNIVERSITY OF LONDON	伦敦玛丽大学皇后分校
UNIVERSITY AT ALBANY, SUNY	纽约州立大学奥尔巴尼分校
NATIONAL TSING HUA UNIVERSITY	国立清华大学
YOKOHAMA NATIONAL UNIVERSITY	横滨国立大学
VICTORIA UNIVERSITY, AUSTRALIA	维多利亚大学, 澳大利亚
UNIVERSITY OF OREGON	俄勒冈大学
UNIVERSITY OF STRATHCLYDE	斯特拉斯克莱德大学
WUHAN UNIVERSITY OF SCIENCE AND TECHNOLOGY	武汉科技大学
MACAU UNIVERSITY OF SCIENCE AND TECHNOLOGY	澳门科技大学
HONG KONG BAPTIST UNIVERSITY	香港浸会大学
CHINA CENTER FOR ECONOMIC RESEARCH	中国经济研究中心
SHAANXI UNIVERSITY OF SCIENCE AND TECHNOLOGY	陕西科技大学
HENAN UNIVERSITY	河南大学
INSTITUT NATIONAL AGRONOMIQUE PARIS GRIGNON	巴黎格纳国家农艺研究所学院
NEUROCRINE BIOSCIENCES	神经生物科学
CELL SIGNALING TECHNOLOGY	细胞信号技术
UNIVERSITY OF WESTERN ONTARIO	西安大略大学
NAGASAKI UNIVERSITY	长崎大学
ZHENGZHOU UNIVERSITY OF LIGHT INDUSTRY	郑州轻工业大学
NOVOZYMES	诺维信
UNIVERSITY OF ALABAMA AT BIRMINGHAM	阿拉巴马大学伯明翰分校
UOP LLC	UOP 有限责任公司
KING ABDULAZIZ UNIVERSITY	阿卜杜拉国王大学
CENTRAL QUEENSLAND UNIVERSITY	中央昆士兰大学
SHANXI TEACHERS UNIVERSITY	山西师范大学
UNIVERSITY OF TEXAS HEALTH SCIENCE CENTER AT HOUSTON	德克萨斯大学休斯敦健康科学中心
ROCKEFELLER UNIVERSITY	洛克菲勒大学
UNIVERSITY OF TEXAS AT DALLAS	德克萨斯大学达拉斯分校
NATIONAL INSTITUTE OF STANDARDS AND TECHNOLOGY	国家标准与技术研究所
DRESDEN UNIVERSITY OF TECHNOLOGY	德累斯顿理工大学
NORFOLK STATE UNIVERSITY	诺福克州立大学
MCKNIGHT BRAIN INSTITUTE	麦克奈特脑研究所
UNIVERSITY OF TEXAS HEALTH SCIENCE CENTER AT SAN ANTONIO	德克萨斯大学圣安东尼奥健康科学中心
UNITED STATES DEPARTMENT OF AGRICULTURE	美国农业部
CANON INC.	佳能公司
FAYETTEVILLE STATE UNIVERSITY	费耶特维尔州立大学
ERICSSON	爱立信
SOUTH DAKOTA STATE UNIVERSITY	南达科他州立大学
UNIVERSITY OF PARIS-SUD	巴黎第十一大学
MOREHOUSE SCHOOL OF MEDICINE	莫浩斯医学院
INTERNATIONAL MAIZE AND WHEAT IMPROVEMENT CENTER	国际玉米与小麦改良中心
NANTONG UNIVERSITY	南通大学
FLORIDA INTERNATIONAL UNIVERSITY	佛罗里达国际大学
CENTER FOR DRUG EVALUATION AND RESEARCH	药物评价与研究中心
CYPRESS SEMICONDUCTOR	柏树半导体
CHINA CENTER OF ADVANCED SCIENCE AND TECHNOLOGY	中国先进科技中心
HENNEPIN COUNTY MEDICAL CENTER	亨内平县医疗中心
CATERPILLAR INC.	卡特彼勒公司
ST LUKES EPISCOPAL HOSPITAL	圣 LUKES 主教医院
UNIVERSITY OF TOLEDO	托莱多大学
ANHUI NORMAL UNIVERSITY	安徽师范大学
HEBEI MEDICAL UNIVERSITY	河北医科大学
UNIVERSITY OF TENNESSEE HEALTH SCIENCE CENTER	田纳西大学健康科学中心
SEOUL NATIONAL UNIVERSITY	首尔国立大学
GENENTECH	GENENTECH
LG ELECTRONICS	LG电子
PARKE-DAVIS	帕克-戴维斯
INNER MONGOLIA UNIVERSITY OF TECHNOLOGY	内蒙古理工大学
UNIVERSITY OF CANTERBURY	坎特伯雷大学
UNIVERSITY OF MISSOURI	密苏里大学
KING ABDULLAH UNIVERSITY OF SCIENCE AND TECHNOLOGY	阿卜杜拉国王科技大学
UNIVERSITY OF TENNESSEE	田纳西大学
MEIJO UNIVERSITY	名城大学
HOSPITAL FOR SICK CHILDREN	生病儿童医院
MOUNT SINAI HOSPITAL, TORONTO	多伦多西奈山医院
DARTMOUTH COLLEGE	达特茅斯学院
TENCENT	腾讯
HUANGGANG NORMAL UNIVERSITY	黄冈师范大学
CHINA MOBILE	中国移动
UTAH STATE UNIVERSITY	犹他州立大学
GENERAL ELECTRIC	通用电气
ROYAL MILITARY COLLEGE OF CANADA	加拿大皇家军事学院
WEST VIRGINIA UNIVERSITY	西弗吉尼亚大学
ABB LTD	ABB有限公司
UNIVERSITY OF MASSACHUSETTS DARTMOUTH	马萨诸塞州达特茅斯大学
CENTER FOR FOOD SAFETY AND APPLIED NUTRITION	食品安全与应用营养中心
UNIVERSITY OF VICTORIA	维多利亚大学
BOEHRINGER INGELHEIM	勃林格殷格翰
CHILDREN'S HOSPITAL OF WISCONSIN	威斯康星州儿童医院
EXXONMOBIL	埃克森 美孚
STOWERS INSTITUTE FOR MEDICAL RESEARCH	STOWERS 医学研究所
SPANISH NATIONAL RESEARCH COUNCIL	西班牙国家研究委员会
MEMORIAL UNIVERSITY OF NEWFOUNDLAND	纽芬兰纪念大学
SHANDONG NORMAL UNIVERSITY	山东师范大学
CARNEGIE LEARNING	卡内基学习
CHEUNG KONG GRADUATE SCHOOL OF BUSINESS	长江商学院
TEXAS CHRISTIAN UNIVERSITY	德克萨斯基督教大学
WOMEN'S AND CHILDREN'S HOSPITAL	妇女儿童医院
SHENZHEN UNIVERSITY	深圳大学
CHENGDU UNIVERSITY OF TECHNOLOGY	成都理工大学
UNIVERSITY OF COPENHAGEN	哥本哈根大学
LAFARGE	拉法基
UNIVERSITY OF KASSEL	卡塞尔大学
MISSISSIPPI STATE UNIVERSITY	密西西比州立大学
UNIVERSITY OF MARYLAND, BALTIMORE COUNTY	马里兰大学巴尔的摩分校
HYDROLOGIC RESEARCH CENTER	水文研究中心
MEMORIAL SLOAN KETTERING CANCER CENTER	纪念斯隆凯特林癌症中心
BEIJING GENOMICS INSTITUTE	北京基因组研究所
HUAQIAO UNIVERSITY	华侨大学
SINOVAC BIOTECH	北京科兴生物科技
KING'S COLLEGE LONDON	伦敦国王学院
VIRGINIA MASON MEDICAL CENTER	弗吉尼亚梅森医疗中心
INDIANA UNIVERSITY	印第安纳大学
XINJIANG UNIVERSITY	新疆大学
WAYNE STATE UNIVERSITY	韦恩州立大学
RENSSELAER POLYTECHNIC INSTITUTE	伦斯勒理工学院
UNIVERSITY OF JINAN	济南大学
HOSPITAL FOR SPECIAL SURGERY	特殊外科医院
CHANG GUNG UNIVERSITY	长庚大学
UNIVERSITY OF MACAU	澳门大学
TIANJIN UNIVERSITY OF TRADITIONAL CHINESE MEDICINE	天津中医药大学
BEIJING UNIVERSITY OF CIVIL ENGINEERING AND ARCHITECTURE	北京建筑工程学院
NAGAOKA UNIVERSITY OF TECHNOLOGY	长冈技术科学大学
GLAXOSMITHKLINE	GLAXOSMITHKLINE
AGILENT TECHNOLOGIES	安捷伦技术
BRIGHAM AND WOMEN'S HOSPITAL	布列根和妇女医院
LIAONING UNIVERSITY OF TECHNOLOGY	辽宁工业大学
KAROLINSKA INSTITUTET	卡洛琳斯卡卡若琳
DOW AGROSCIENCES	陶氏农业科学
THE GEORGE INSTITUTE FOR GLOBAL HEALTH	乔治全球健康研究所
UNIVERSITY OF OXFORD	牛津大学
VANDERBILT UNIVERSITY MEDICAL CENTER	范德比尔特大学医疗中心
HENRY FORD HEALTH SYSTEM	亨利. 福特医疗系统
COLLEGE OF CHARLESTON	查尔斯顿学院
BC CANCER AGENCY	BC癌症局
JOHNS MANVILLE	约翰曼维尔
UNIVERSITY OF COLOGNE	科隆大学
TECHNICAL UNIVERSITY OF DENMARK	丹麦技术大学
ROY J. AND LUCILLE A. CARVER COLLEGE OF MEDICINE	罗伊 J. 和露西尔医学学院
PETROCHINA	中石油
UNIVERSITY OF MANITOBA	马尼托巴省大学
UNIVERSITY OF WUPPERTAL	伍伯托大学
NORTHEAST PETROLEUM UNIVERSITY	东北石油大学
UNIVERSITY OF NEW ORLEANS	新奥尔良大学
UNIVERSITY OF HARTFORD	哈特福德大学
TIANJIN MEDICAL UNIVERSITY	天津医科大学
UNIVERSITY OF TOLEDO MEDICAL CENTER	托莱多大学医疗中心
UNIVERSITY OF MEMPHIS	孟菲斯大学
BAE SYSTEMS	BAE公司
ALCORN STATE UNIVERSITY	奥尔康州立大学
CLEMSON UNIVERSITY	克莱姆森大学
UNIVERSITY OF LOUISVILLE	路易斯维尔大学
ULTRA	超
ROYAL INSTITUTE OF TECHNOLOGY	皇家理工学院
INFORMATION TECHNOLOGY INSTITUTE	信息技术研究所
BEIJING INSTITUTE OF FOREIGN TRADE	北京对外贸易学院
CLEVELAND STATE UNIVERSITY	克利夫兰州立大学
HENAN NORMAL UNIVERSITY	河南师范大学
CHONBUK NATIONAL UNIVERSITY	全北国立大学
KEIO UNIVERSITY	庆应义塾大学
TOKYO INSTITUTE OF TECHNOLOGY	东京理工学院
KAOHSIUNG MEDICAL UNIVERSITY	高雄医科大学
MEDICAL COLLEGE OF WISCONSIN	威斯康星医科大学
KEAN UNIVERSITY	肯恩大学
DELTA AIR LINES	达美航空公司
NAGOYA INSTITUTE OF TECHNOLOGY	名古屋理工学院
OKLAHOMA STATE UNIVERSITY–STILLWATER	俄克拉荷马州立大学
CITY COLLEGE OF NEW YORK	纽约城市学院
UNION COLLEGE	联合学院
YANTAI UNIVERSITY	烟台大学
NATIONAL RENEWABLE ENERGY LABORATORY	国家可再生能源实验室
ROYAL WOMEN'S HOSPITAL	皇家女子医院
CHANGSHA UNIVERSITY OF SCIENCE AND TECHNOLOGY	长沙理工大学
YESHIVA UNIVERSITY	耶什华大学
BOSTON COLLEGE	波士顿学院
ORACLE CORPORATION	甲骨文公司
CAPITAL NORMAL UNIVERSITY	首都师范大学
NORTH UNIVERSITY OF CHINA	中北大学
HEILONGJIANG UNIVERSITY	黑龙江大学
FUJIAN AGRICULTURE AND FORESTRY UNIVERSITY	福建农林大学
AGRICULTURE AND AGRI-FOOD CANADA	加拿大农业和农食品
HANGZHOU DIANZI UNIVERSITY	杭州电子科技大学
JOINT GENOME INSTITUTE	联合基因组研究所
UNIVERSITY OF NEWCASTLE	纽卡斯尔大学
CENTER FOR ADVANCED BIOTECHNOLOGY AND MEDICINE	先进生物技术与医学中心
UNIVERSITY OF YORK	约克大学
INNER MONGOLIA UNIVERSITY FOR NATIONALITIES	内蒙古民族大学
GUANGZHOU INSTITUTES OF BIOMEDICINE AND HEALTH	广州生物医学与健康研究所
ADVANCED MICRO DEVICES	先进的微型设备
BIOGEN IDEC	鲍勃哈姆 IDEC
TAIPEI VETERANS GENERAL HOSPITAL	台北退伍军人总医院
UNIVERSITY OF TEXAS AT SAN ANTONIO	德克萨斯大学圣安东尼奥分校
SWINBURNE UNIVERSITY OF TECHNOLOGY	史文朋科技大学
UNIVERSITY OF GEORGIA	佐治亚大学
UNIVERSITY OF REGINA	里贾纳大学
GEORGE WASHINGTON UNIVERSITY	乔治华盛顿大学
IEEE COMPUTER SOCIETY	IEEE 计算机学会
DALIAN MEDICAL UNIVERSITY	大连医科大学
PARIS DIDEROT UNIVERSITY	巴黎狄德罗大学
EISAI	卫材
NATIONAL INSTITUTE OF GENETICS	国立遗传学研究所
CURTIN UNIVERSITY	科廷大学
UNIVERSITY OF OCCUPATIONAL AND ENVIRONMENTAL HEALTH JAPAN	日本职业与环境健康大学
UNIVERSITY OF MASSACHUSETTS AMHERST	马萨诸塞州大学阿默斯特分校
SINGAPORE SCIENCE PARK	新加坡科学园
SEAGATE TECHNOLOGY	希捷科技
CABOT CORPORATION	卡伯特公司
UNIVERSITY OF LONDON	伦敦大学
EWHA WOMANS UNIVERSITY	梨花女子大学
DUPONT PIONEER	杜邦先驱
VIRGINIA TECH	弗吉尼亚理工大学
APPLIED MATERIALS	应用材料
QUEEN'S UNIVERSITY	皇后大学
HUNAN NORMAL UNIVERSITY	湖南师范大学
HENRY FORD HOSPITAL	亨利·福特医院
KUNMING INSTITUTE OF ZOOLOGY	昆明动物学研究所
LEIDEN UNIVERSITY MEDICAL CENTER	莱顿大学医疗中心
PHILIPS	飞利浦
PENN STATE MILTON S. HERSHEY MEDICAL CENTER	宾夕法尼亚州立大学密尔顿·赫尔希医学中心
WESTINGHOUSE ELECTRIC	西屋电气
EUROPEAN BIOINFORMATICS INSTITUTE	欧洲生物信息学研究所
CARLETON COLLEGE	卡尔顿学院
CENTER FOR ECONOMIC STUDIES	经济研究中心
LEHIGH UNIVERSITY	理海大学
THE FEINSTEIN INSTITUTE FOR MEDICAL RESEARCH	芬斯坦医学研究所
SCIENCE NORTH	科学北
KING ABDULAZIZ CITY FOR SCIENCE AND TECHNOLOGY	阿卜杜拉国王科技城
SINGAPORE MANAGEMENT UNIVERSITY	新加坡管理大学
SOUTHERN ILLINOIS UNIVERSITY CARBONDALE	南伊利诺伊大学卡本代尔分校
CHONGQING COMMUNICATION INSTITUTE	重庆交通学院
UNIVERSITY OF OTTAWA	渥太华大学
HUBEI UNIVERSITY OF CHINESE MEDICINE	湖北中医药大学
JEWISH GENERAL HOSPITAL	犹太总医院
FREE UNIVERSITY OF BERLIN	柏林自由大学
FACEBOOK	Facebook
MONTREAL NEUROLOGICAL INSTITUTE AND HOSPITAL	蒙特利尔神经研究所和医院
INSTITUT D'ASTROPHYSIQUE DE PARIS	巴黎天体物理学研究所
NATIONAL SCIENCE FOUNDATION	国家科学基金会
YEUNGNAM UNIVERSITY	岭南大学
UNIVERSITY OF TURKU	图尔库大学
JIANGXI UNIVERSITY OF FINANCE AND ECONOMICS	江西财经大学
LUDONG UNIVERSITY	鲁东大学
NATIONAL BUREAU OF ECONOMIC RESEARCH	国家经济研究局
TEXAS INSTRUMENTS	德州仪器
WUHAN INSTITUTE OF TECHNOLOGY	武汉理工学院
UNIVERSITY OF TEXAS MEDICAL BRANCH	德克萨斯大学医学分会
COLD SPRING HARBOR LABORATORY	冷泉港实验室
HUBEI UNIVERSITY OF TECHNOLOGY	湖北工业大学
HEFEI INSTITUTES OF PHYSICAL SCIENCE	合肥物理科学研究院
PUKYONG NATIONAL UNIVERSITY	釜庆国立大学
NANJING FORESTRY UNIVERSITY	南京林业大学
OREGON STATE UNIVERSITY	俄勒冈州立大学
HO CHI MINH CITY UNIVERSITY OF TECHNOLOGY	胡志明市理工大学
KYUSHU UNIVERSITY	九州大学
HUMAN GENOME SEQUENCING CENTER	人类基因组测序中心
UNIVERSITY OF AUCKLAND	奥克兰大学
BOISE STATE UNIVERSITY	博伊西州立大学
RADBOUD UNIVERSITY NIJMEGEN	拉德堡德大学
BAR-ILAN UNIVERSITY	巴伊兰大学
UNIVERSITY OF ALABAMA	阿拉巴马大学
ALBERT EINSTEIN COLLEGE OF MEDICINE	阿尔伯特·爱因斯坦医学院
UNIVERSITY OF SHANGHAI FOR SCIENCE AND TECHNOLOGY	上海理工大学
MERCEDES-BENZ	梅赛德斯-奔驰
MEDICAL UNIVERSITY OF SOUTH CAROLINA	南卡罗来纳州医科大学
EAST CAROLINA UNIVERSITY	东卡罗莱纳大学
COLUMBIA UNIVERSITY MEDICAL CENTER	哥伦比亚大学医疗中心
JINGDEZHEN CERAMIC INSTITUTE	景德镇陶瓷研究所
LUND UNIVERSITY	隆德大学
PASTEUR INSTITUTE	巴斯德研究所
HEBEI NORMAL UNIVERSITY	河北师范大学
BECKMAN RESEARCH INSTITUTE	贝克曼研究所
BAYER	拜耳
UNIVERSITY OF MONTANA	蒙大拿大学
NATIONAL INSTITUTE FOR MATERIALS SCIENCE	国立材料科学研究院
CHINA JILIANG UNIVERSITY	中国计量大学
NATIONAL MUSEUM OF NATURAL HISTORY	国立自然历史博物馆
NATIONAL HEALTH RESEARCH INSTITUTES	国家卫生研究机构
HERIOT-WATT UNIVERSITY	赫瑞瓦特大学
BAIDU	百度
LINGNAN UNIVERSITY	岭南大学
QINGDAO AGRICULTURAL UNIVERSITY	青岛农业大学
LEIBNIZ ASSOCIATION	莱布尼茨协会
UNIVERSITY OF DUISBURG-ESSEN	杜伊斯堡-埃森大学
SAM HOUSTON STATE UNIVERSITY	萨姆休斯顿州立大学
NATURAL RESOURCES CANADA	加拿大自然资源
WAGENINGEN UNIVERSITY AND RESEARCH CENTRE	瓦赫宁大学和研究中心
LA TROBE UNIVERSITY	乐卓博大学
MENTOR GRAPHICS	明导
QINGDAO TECHNOLOGICAL UNIVERSITY	青岛理工大学
TECHNICAL UNIVERSITY OF BERLIN	柏林技术大学
UNIVERSITY OF ARKANSAS AT LITTLE ROCK	阿肯色州小岩大学
AUSTRALIAN CENTRE FOR PLANT FUNCTIONAL GENOMICS	澳大利亚植物功能基因组学中心
JINGGANGSHAN UNIVERSITY	井冈山大学
NEW JERSEY INSTITUTE OF TECHNOLOGY	新泽西州理工学院
WRIGHT STATE UNIVERSITY	莱特州立大学
THE TURING INSTITUTE	图灵研究所
UNIVERSITY OF ANTWERP	安特卫普大学
ELECTRIC POWER RESEARCH INSTITUTE	电力研究院
UNIVERSITY OF RHODE ISLAND	罗德岛大学
ENGELHARD	安格
INTERNATIONAL WATER MANAGEMENT INSTITUTE	国际水管理研究所
CONCORDIA UNIVERSITY	协和大学
SINGAPORE UNIVERSITY OF TECHNOLOGY AND DESIGN	新加坡理工大学设计学院
UNIVERSITY OF ADELAIDE	阿德莱德大学
OLD DOMINION UNIVERSITY	欧道明大学
PHARMACIA	法玛西亚
UNIVERSITY OF IDAHO	爱达荷州大学
UNIVERSITY OF ELECTRO-COMMUNICATIONS	电子通信大学
UNIVERSITY OF SASKATCHEWAN	萨斯喀彻温省大学
GERMAN CANCER RESEARCH CENTER	德国癌症研究中心
NATIONAL CENTER FOR ATMOSPHERIC RESEARCH	国家大气研究中心
UNIVERSITY OF VALENCIA	瓦伦西亚大学
NATIONAL CHIAO TUNG UNIVERSITY	侨东大学
MICRON TECHNOLOGY	微米技术
KAIST	韩国科学技术院
CROPS RESEARCH INSTITUTE	农作物研究所
FUJIAN NORMAL UNIVERSITY	福建师范大学
SLAC NATIONAL ACCELERATOR LABORATORY	SLAC 国家加速器实验室
KING'S COLLEGE	国王学院
UNITED STATES NAVAL RESEARCH LABORATORY	美国海军研究实验室
LEIDEN UNIVERSITY	莱顿大学
UNIVERSITY HEALTH NETWORK	大学健康网络
SAITAMA UNIVERSITY	埼玉大学
YAHOO!	雅虎
GUANGZHOU UNIVERSITY	广州大学
CHINESE MINISTRY OF HEALTH	中国卫生部
INTERDIGITAL, INC.	国际数码公司
ARMAGH OBSERVATORY	阿马天文台
UNIVERSITY OF BARCELONA	巴塞罗那大学
BOHAI UNIVERSITY	渤海大学
ROSWELL PARK CANCER INSTITUTE	罗斯威尔公园癌症研究所
SHIHEZI UNIVERSITY	石河子大学
CLARK UNIVERSITY	克拉克大学
LONDON SOUTH BANK UNIVERSITY	伦敦南岸大学
NORWICH RESEARCH PARK	诺维奇研究园
NTT DOCOMO	NTT DOCOMO
SOUTH UNIVERSITY OF SCIENCE AND TECHNOLOGY OF CHINA	南方科技大学
KANAZAWA UNIVERSITY	金泽大学
ERASMUS UNIVERSITY ROTTERDAM	鹿特丹伊拉斯谟大学
CHINESE ACADEMY OF FISHERY SCIENCES	中国渔业科学院
UNIVERSITY OF FREIBURG	弗莱堡大学
UNIVERSITY OF DEFENCE	国防大学
LOUISIANA TECH UNIVERSITY	路易斯安那理工大学
CEDARS-SINAI MEDICAL CENTER	雪松-西奈医疗中心
WEIZMANN INSTITUTE OF SCIENCE	魏茨曼科学研究院
JACOBS UNIVERSITY BREMEN	雅各布斯大学不来梅分校
COMPLUTENSE UNIVERSITY OF MADRID	马德里康普鲁滕塞大学
STATE UNIVERSITY OF CAMPINAS	坎皮纳州立大学
TARUMANAGARA UNIVERSITY	鲁玛大学
KETTERING UNIVERSITY	凯特琳大学
CHINA THREE GORGES UNIVERSITY	中国三三峡大学
HIROSAKI UNIVERSITY	弘前大学
SHENYANG AGRICULTURAL UNIVERSITY	沈阳农业大学
BIOTECHNOLOGY INSTITUTE	生物技术研究所
ZHEJIANG A & F UNIVERSITY	浙江 A、F 大学
SHENYANG PHARMACEUTICAL UNIVERSITY	沈阳药科大学
UNIVERSITY OF WYOMING	怀俄明州大学
ENERGY RESEARCH INSTITUTE	能源研究所
UNIVERSITY OF HOUSTON SYSTEM	休斯顿大学系统
UNIVERSITY OF HAWAII AT MANOA	夏威夷大学马诺阿分校
ANHUI UNIVERSITY OF TECHNOLOGY	安徽工业大学
SHANGHAI NORMAL UNIVERSITY	上海师范大学
SINGAPORE NATIONAL EYE CENTER	新加坡国家眼科中心
JAPAN ADVANCED INSTITUTE OF SCIENCE AND TECHNOLOGY	日本先进科技研究院
TRIMBLE NAVIGATION	谷歌导航
XINXIANG MEDICAL UNIVERSITY	新乡市医科大学
SANFORD-BURNHAM INSTITUTE FOR MEDICAL RESEARCH	桑福德医学研究所
UNIVERSITY OF JAMMU	查谟大学
TORONTO WESTERN HOSPITAL	多伦多西区医院
UNIVERSITY OF READING	雷丁大学
CHINESE ACADEMY OF SOCIAL SCIENCES	中国社会科学研究院
ENVIRONMENT CANADA	加拿大环境
AGRICULTURAL RESEARCH ORGANIZATION, VOLCANI CENTER	农业研究组织, 马亚沃卡尼中心
LIAONING UNIVERSITY	辽宁大学
UNIVERSITY OF KIEL	基尔大学
NATIONAL CENTRAL UNIVERSITY	国立中央大学
XIAOMI	小米
SHIZUOKA UNIVERSITY	静冈大学
BELL NORTHERN RESEARCH	贝尔北方研究
ZTE	中兴
YUNNAN NORMAL UNIVERSITY	云南师范大学
KOREA UNIVERSITY	韩国大学
ASCI CORPORATION	ASCI 公司
HANGZHOU NORMAL UNIVERSITY	杭州师范大学
DEMOCRATIC REPUBLIC OF THE CONGO MINISTRY OF HEALTH	刚果民主共和国卫生部
SHANXI MEDICAL UNIVERSITY	山西医科大学
LIAONING NORMAL UNIVERSITY	辽宁师范大学
UNIVERSITY OF G?TTINGEN	G 大学？TTINGEN
STEVENS INSTITUTE OF TECHNOLOGY	史蒂文斯理工学院
LUCIDEON	LUCIDEON
CURIE INSTITUTE	居里研究所
NATIONAL CENTER FOR TOXICOLOGICAL RESEARCH	国家毒理学研究中心
HEILONGJIANG UNIVERSITY OF CHINESE MEDICINE	黑龙江中医药大学
JOHN RADCLIFFE HOSPITAL	约翰-拉德克利夫医院
SINGAPORE GENERAL HOSPITAL	新加坡总医院
INTERNATIONAL CENTER FOR AGRICULTURAL RESEARCH IN THE DRY AREAS	国际干旱地区农业研究中心
INNER MONGOLIA AGRICULTURAL UNIVERSITY	内蒙古农业大学
SWEDISH UNIVERSITY OF AGRICULTURAL SCIENCES	瑞典农业科学大学
ANHUI UNIVERSITY	安徽大学
MASSEY UNIVERSITY	梅西大学
UCB	UCB
UNIVERSITY OF MARBURG	马尔堡大学
ANSYS	Ansys
TEXAS TECH UNIVERSITY	德州理工大学
BINZHOU UNIVERSITY	滨州大学
LIAOCHENG UNIVERSITY	聊城大学
FREE UNIVERSITY OF BRUSSELS	布鲁塞尔自由大学
NATIONAL TAIWAN OCEAN UNIVERSITY	国立台湾海洋大学
DATA STORAGE INSTITUTE	数据存储研究所
UNITED STATES DEPARTMENT OF VETERANS AFFAIRS	美国退伍军人事务部
ROCHESTER INSTITUTE OF TECHNOLOGY	罗切斯特理工学院
CALIFORNIA STATE UNIVERSITY	加州州立大学
AGIOS PHARMACEUTICALS	阿基制药
PANASONIC	松下
AMES LABORATORY	艾姆斯实验室
CORNING INC.	康宁公司
YANBIAN UNIVERSITY	延边大学
UNIVERSITY OF BORDEAUX	波尔多大学
KEELE UNIVERSITY	基尔大学
FENG CHIA UNIVERSITY	逢甲大学
GEORGETOWN UNIVERSITY	乔治城大学
SHINSHU UNIVERSITY	信州大学
PROTEIN SCIENCES	蛋白科学公司
ST. JOSEPH'S HOSPITAL AND MEDICAL CENTER	圣约瑟夫医院和医疗中心
AT&T LABS	在 T 实验室
VA BOSTON HEALTHCARE SYSTEM	VA 波士顿医疗保健系统
INSTITUTE OF INSECT SCIENCES, ZHEJIANG UNIVERSITY	浙江大学昆虫科学研究所
IWATE MEDICAL UNIVERSITY	岩手医科大学
SIR RUN RUN SHAW HOSPITAL	邵逸夫医院
ROYAL LIVERPOOL UNIVERSITY HOSPITAL	皇家利物浦大学医院
KANSAI MEDICAL UNIVERSITY	关西医科大学
BAUSCH & LOMB	博士伦
MILITARY HOSPITAL	军队医院
ENVIRON	环境
NATIONAL CHUNG HSING UNIVERSITY	国立中兴大学
ZHEJIANG NORMAL UNIVERSITY	浙江师范大学
SHANDONG UNIVERSITY OF TECHNOLOGY	山东工业大学
AUSTRIAN ACADEMY OF SCIENCES	奥地利科学院
SPACE RESEARCH INSTITUTE	空间研究所
SOUTHERN METHODIST UNIVERSITY	南卫理公会大学
RAYTHEON	雷声
GOVERNMENT OF THE UNITED STATES OF AMERICA	美利坚合众国政府
UNIVERSITY OF COLORADO COLORADO SPRINGS	科罗拉多大学科罗拉多泉分校
CITY UNIVERSITY LONDON	伦敦城市大学
GRIFFITH UNIVERSITY	格里菲斯大学
SOUTHERN ILLINOIS UNIVERSITY EDWARDSVILLE	南伊利诺伊大学爱德华兹维尔分校
INSTITUTE FOR ADVANCED STUDY	高级研究学院
TEXAS A&M UNIVERSITY SYSTEM	德州 A&M 大学系统
LOYOLA UNIVERSITY CHICAGO	芝加哥洛约拉大学
EINDHOVEN UNIVERSITY OF TECHNOLOGY	埃霍温理工大学
HENAN UNIVERSITY OF TECHNOLOGY	河南工业大学
SAINT MARY'S UNIVERSITY	圣玛丽大学
SHANGHAI UNIVERSITY OF ELECTRIC POWER	上海电力大学
SALK INSTITUTE FOR BIOLOGICAL STUDIES	索尔克生物研究所
ATLANTIC OCEANOGRAPHIC AND METEOROLOGICAL LABORATORY	大西洋海洋学和气象实验室
EASTMAN KODAK COMPANY	伊士曼柯达公司
MONASH UNIVERSITY, CLAYTON CAMPUS	莫纳什大学克莱顿校区
NORWEGIAN UNIVERSITY OF SCIENCE AND TECHNOLOGY	挪威科技大学
UNIVERSITY OF STRASBOURG	斯特拉斯堡大学
BAYLOR UNIVERSITY MEDICAL CENTER	贝勒大学医疗中心
BOSTON CHILDREN'S HOSPITAL	波士顿儿童医院
MEDICAL UNIVERSITY OF VIENNA	维也纳医科大学
PARC	施乐帕克研究中心
KOBE UNIVERSITY	神户大学
UNIVERSITY OF GLASGOW	格拉斯哥大学
HONG KONG MONETARY AUTHORITY	香港金融管理局
UNIVERSITY OF DUISBURG	杜伊斯堡大学
CHINA ACADEMY OF ENGINEERING PHYSICS	中国工程物理研究院
WALSH UNIVERSITY	沃尔什大学
GUILIN UNIVERSITY OF ELECTRONIC TECHNOLOGY	桂林电子科技大学
CHIRON CORPORATION	巨浪公司
HONEYWELL	霍尼韦尔
BINGHAMTON UNIVERSITY	纽约州立大学宾汉姆顿分校
UNIVERSITY OF BRADFORD	布拉德福德大学
MIAMI UNIVERSITY	迈阿密大学
UNIVERSITY OF GENEVA	日内瓦大学
NATIONAL NATURAL SCIENCE FOUNDATION OF CHINA	中国国家自然科学基金
SPACE SCIENCE INSTITUTE	空间科学研究所
FUJIAN MEDICAL UNIVERSITY	福建医科大学
UNIVERSITY OF FUKUI	福井大学
HEIDELBERG UNIVERSITY	海德堡大学
UNIVERSITY OF MASSACHUSETTS BOSTON	马萨诸塞州波士顿大学
UNIVERSITY OF ALABAMA IN HUNTSVILLE	阿拉巴马大学亨茨维尔分校
TIANJIN POLYTECHNIC UNIVERSITY	天津工业大学
HUNAN COLLEGE OF FINANCE AND ECONOMICS	湖南财经学院
SHANDONG UNIVERSITY OF SCIENCE AND TECHNOLOGY	山东科技大学
TOKYO METROPOLITAN UNIVERSITY	东京都立大学
RUIJIN HOSPITAL	瑞金医院
UNIVERSITY OF KENT	肯特大学
TIANJIN UNIVERSITY OF SCIENCE AND TECHNOLOGY	天津科技大学
UNIVERSITY OF ERLANGEN-NUREMBERG	埃朗根大学-纽伦堡分校
NETAPP	NETAPP
LANCASTER UNIVERSITY	兰开斯特大学
STMICROELECTRONICS	意法半导体
ARCO	阿科
UNIVERSITY OF REGENSBURG	雷根斯堡大学
TOKYO UNIVERSITY OF AGRICULTURE AND TECHNOLOGY	东京农业技术大学
DESERT RESEARCH INSTITUTE	沙漠研究所
ROSKAMP INSTITUTE	罗斯坎普研究所
SHANGHAI UNIVERSITY OF ENGINEERING SCIENCES	上海工程科学大学
BRUNEL UNIVERSITY LONDON	布鲁内尔大学伦敦分校
MELBOURNE INSTITUTE OF TECHNOLOGY	墨尔本理工学院
RUSSIAN ACADEMY OF SCIENCES	俄罗斯科学院
SAINT PETER'S UNIVERSITY	圣彼得大学
GEOLOGICAL SURVEY OF CANADA	加拿大地质调查
OAKLAND UNIVERSITY	奥克兰大学
CARNEGIE INSTITUTION FOR SCIENCE	卡内基科学研究院
FLEXTRONICS	伟创力
FORD MOTOR COMPANY	福特汽车公司
VILLANOVA UNIVERSITY	维拉诺瓦大学
DEPAUL UNIVERSITY	德保罗大学
VIRGINIA BIOINFORMATICS INSTITUTE	弗吉尼亚生物信息学研究所
NIIGATA UNIVERSITY	新泻大学
UNIVERSITY OF NEVADA, RENO	内华达州大学雷诺分校
UNIVERSITY OF MAINZ	美因茨大学
NORTHWEST UNIVERSITY FOR NATIONALITIES	西北民族大学
XI'AN POLYTECHNIC UNIVERSITY	西安理工大学
WILMINGTON UNIVERSITY	威尔明顿大学
IBARAKI UNIVERSITY	茨城大学
ROYAL INSTITUTION	皇家学院
CARDIAC PACEMAKERS, INC.	心脏起搏器公司
ST. JUDE MEDICAL	圣裘德医疗
PENNINGTON BIOMEDICAL RESEARCH CENTER	生物医学研究中心
THE WALLACE H. COULTER DEPARTMENT OF BIOMEDICAL ENGINEERING	华莱士生物医学工程系
BAKER IDI HEART AND DIABETES INSTITUTE	心脏与糖尿病研究所
TIANJIN MEDICAL UNIVERSITY CANCER INSTITUTE AND HOSPITAL	天津医科大学癌症研究所和医院
UNKNOWN INSTITUTE	未知研究所
TUFTS UNIVERSITY	塔夫茨大学
SHANGHAI JIAO TONG UNIVERSITY	上海交通大学
ASTON UNIVERSITY	阿斯顿大学
LANZHOU UNIVERSITY	兰州大学
UNIVERSITY OF ILLINOIS AT URBANA–CHAMPAIGN	伊利诺伊大学厄巴纳-香槟分校
IBM	Ibm
M/A-COM TECHNOLOGY SOLUTIONS	技术解决方案
SOUTHEAST UNIVERSITY	东南大学
CHINESE PLA GENERAL HOSPITAL	中国人民解放军总医院
BOYCE THOMPSON INSTITUTE FOR PLANT RESEARCH	博伊斯植物研究研究所
UNIVERSITY OF CALIFORNIA, SAN DIEGO	加州大学圣地亚哥分校
CATHOLIC UNIVERSITY OF KOREA	加图立大学
GUANGXI NORMAL UNIVERSITY	广西师范大学
CHINA AERODYNAMICS RESEARCH AND DEVELOPMENT CENTER	中国空气动力学研究开发中心
NANOSYS	纳米系统公司
NATIONAL INSTITUTE OF ADVANCED INDUSTRIAL SCIENCE AND TECHNOLOGY	国家先进工业科技研究院
QIQIHAR UNIVERSITY	齐齐哈尔大学
NAVAL UNIVERSITY OF ENGINEERING	海军工程大学
ITHACA COLLEGE	伊萨卡学院
ALCATEL-LUCENT	阿尔卡特-朗讯
DE MONTFORT UNIVERSITY	德孟福尔大学
DONGGUAN UNIVERSITY OF TECHNOLOGY	东莞理工大学
MONTANA STATE UNIVERSITY	蒙大拿州立大学
UNIVERSITY OF HELSINKI	赫尔辛基大学
NEC	Nec
ROBERT KOCH INSTITUTE	罗伯特. 科赫研究所
CANADA CENTRE FOR REMOTE SENSING	加拿大遥感中心
SOUTH CHINA AGRICULTURAL UNIVERSITY	华南农业大学
ENVIRONMENTAL PROTECTION ADMINISTRATION	环境保护管理
KAVLI INSTITUTE FOR THEORETICAL PHYSICS	KAVLI 理论物理研究所
AARHUS UNIVERSITY	奥胡斯大学
HARBIN UNIVERSITY	哈尔滨大学
UNIVERSITY OF TOKYO	东京大学
DISCOVERY INSTITUTE	发现研究所
NORWICH UNIVERSITY	诺维奇大学
TEXAS A&M HEALTH SCIENCE CENTER	德州 A&M 健康科学中心
MINISTRY OF LAND AND RESOURCES OF THE PEOPLE'S REPUBLIC OF CHINA	中华人民共和国土地和资源部
LIVESTOCK IMPROVEMENT CORPORATION	家畜改良公司
EMORY UNIVERSITY	埃默里大学
FREESCALE SEMICONDUCTOR	飞思卡尔半导体
COWLES FOUNDATION	考尔斯基金会
GE HEALTHCARE	GE 医疗保健
SAINT PETERSBURG STATE UNIVERSITY	圣彼得堡州立大学
UNIVERSITY OF TWENTE	特文特大学
HEFEI NORMAL UNIVERSITY	合肥师范大学
SOUTHWEST UNIVERSITY FOR NATIONALITIES	西南民族大学
UNIVERSITY OF LEICESTER	莱斯特大学
UNIVERSITY OF CALIFORNIA, IRVINE	加州大学欧文分校
CENTRAL CHINA NORMAL UNIVERSITY	华中师范大学
NATIONAL SUN YAT-SEN UNIVERSITY	中山大学国立中山大学
NORTHEAST AGRICULTURAL UNIVERSITY	东北农业大学
VCU MEDICAL CENTER	VCU 医疗中心
LANZHOU UNIVERSITY OF TECHNOLOGY	兰州理工大学
UNIVERSIDAD DE BOGOT? JORGE TADEO LOZANO	波哥大大学？乔治 TADEO LOZANO
CHINA SOUTHERN POWER GRID COMPANY	中国南方电网公司
NOVA SOUTHEASTERN UNIVERSITY	诺瓦东南大学
LAMONT–DOHERTY EARTH OBSERVATORY	拉蒙特-多尔蒂地球观测站
ALLEGHENY UNIVERSITY OF THE HEALTH SCIENCES	阿勒格尼健康科学大学
SONY BROADCAST & PROFESSIONAL RESEARCH LABORATORIES	索尼广播和专业研究实验室
UNIVERSITY OF BOLTON	博尔顿大学
LONDON RESEARCH INSTITUTE	伦敦研究所
UNIVERSITY OF FERRARA	费拉拉大学
BIO-RAD LABORATORIES	bio-rad 实验室
CISCO SYSTEMS, INC.	思科系统公司
AMAZON.COM	亚马逊
KINGSTON UNIVERSITY	金斯敦大学
ODENSE UNIVERSITY	欧登塞大学
MOUNT SINAI HOSPITAL	西奈山医院
INTERNATIONAL AGENCY FOR RESEARCH ON CANCER	国际癌症研究机构
CHINA EARTHQUAKE ADMINISTRATION	中国地震局
KEK	高能加速器研究机构
SHENYANG UNIVERSITY	沈阳大学
VACCINE RESEARCH CENTER	疫苗研究中心
STATE OCEANIC ADMINISTRATION	国家海洋管理局
UNIVERSITY OF SOUTH AUSTRALIA	南澳大利亚大学
JIANGXI UNIVERSITY OF SCIENCE AND TECHNOLOGY	江西科技大学
GENTOFTE HOSPITAL	GENTOFTE 医院
KOSAN BIOSCIENCES	高山生物科学
HUNAN INSTITUTE OF SCIENCE AND TECHNOLOGY	湖南科学技术学院
BLACKBERRY LIMITED	黑莓有限公司
AGRICULTURE AND FORESTRY UNIVERSITY	农林大学
UNIVERSITY OF HOHENHEIM	HOHENHEIM 大学
CENTER FOR INFORMATION TECHNOLOGY	信息技术中心
ROYAL CHILDREN'S HOSPITAL	皇家儿童医院
GENENCOR	杰能科
INSPUR	浪潮
INDIANA UNIVERSITY BLOOMINGTON	印第安纳大学布卢明顿
NATIONAL TAIWAN UNIVERSITY OF SCIENCE AND TECHNOLOGY	国立台湾科技大学
NATIONAL RESOURCE CENTER	国家资源中心
THE INSTITUTE OF OPTICS	光学研究所
TIANJIN URBAN CONSTRUCTION INSTITUTE	天津市建设学院
DALIAN POLYTECHNIC UNIVERSITY	大连工业大学
NORTHERN HOSPITAL	北方医院
SHENYANG	沈阳
NATIONAL UNITED UNIVERSITY	国立联合大学
NEW MEXICO STATE UNIVERSITY	新墨西哥州立大学
NATIONAL INSTITUTE FOR NANOTECHNOLOGY	国家纳米技术研究所
YUNNAN AGRICULTURAL UNIVERSITY	云南农业大学
AIR PRODUCTS & CHEMICALS	航空产品和化学品
WALTER REED ARMY INSTITUTE OF RESEARCH	沃尔特. 里德陆军研究所
MINISTRY OF WATER RESOURCES	水利部
CALIFORNIA HEALTH AND HUMAN SERVICES AGENCY	加利福尼亚卫生和人类服务局
BEIJING TECHNOLOGY AND BUSINESS UNIVERSITY	北京工商大学
NATIONAL OCEANIC AND ATMOSPHERIC ADMINISTRATION	国家海洋和大气管理局
NATIONAL UNIVERSITY OF IRELAND, GALWAY	爱尔兰国立大学, 戈尔韦
COLLEGE OF FISHERIES	渔业学院
CHUNG SHAN MEDICAL UNIVERSITY	中山医学大学
UNION UNIVERSITY	联合大学
SILICONWARE PRECISION INDUSTRIES COMPANY, LTD.	SILICONWARE 精密工业股份有限公司
XUCHANG UNIVERSITY	许昌大学
LINK?PING UNIVERSITY	林雪平大学
UNIVERSITY OF NANTES	南特大学
GUANGDONG OCEAN UNIVERSITY	广东海洋大学
CENTER FOR FOOD SAFETY	食品安全中心
UNIVERSITY OF NEW HAMPSHIRE	新罕布什尔州大学
WICHITA STATE UNIVERSITY	威奇托州立大学
CARDIOVASCULAR INSTITUTE OF THE SOUTH	南方心血管研究所
HARBIN UNIVERSITY OF SCIENCE AND TECHNOLOGY	哈尔滨科技大学
TEXAS STATE UNIVERSITY	德克萨斯州立大学
SINGAPORE–MIT ALLIANCE	新加坡-麻省理工学院学术联盟
BARUCH COLLEGE	巴里学院
HUNAN AGRICULTURAL UNIVERSITY	湖南农业大学
ROYAL PRINCE ALFRED HOSPITAL	皇家阿尔弗雷德亲王医院
FAIRFIELD HOSPITAL	费尔菲尔德医院
UNIVERSITY OF OKLAHOMA HEALTH SCIENCES CENTER	俄克拉何马州大学健康科学中心
YORK UNIVERSITY	约克大学
ST VINCENT HOSPITAL	圣云仙医院
JIANGSU UNIVERSITY	江苏大学
FURMAN UNIVERSITY	弗曼大学
AUTONOMOUS UNIVERSITY OF MADRID	马德里自治大学
KYUNG HEE UNIVERSITY	庆熙大学
SWANSEA UNIVERSITY	斯旺西大学
JAPAN AGENCY FOR MARINE-EARTH SCIENCE AND TECHNOLOGY	日本海洋科学技术局
BAKER HUGHES	贝克休斯
CHINA UNIVERSITY OF SCIENCE AND TECHNOLOGY	中国科学技术大学
RYUKOKU UNIVERSITY	龙谷大学
FOUNDATION MEDICINE	基础医学
SUNGKYUNKWAN UNIVERSITY	成均馆大学
INDIANA STATE UNIVERSITY	印第安纳州立大学
TOKYO ELECTRIC POWER COMPANY	东京电力公司
AARON DIAMOND AIDS RESEARCH CENTER	亚伦钻石艾滋病研究中心
MEISEI UNIVERSITY	明星大学
JIANGXI AGRICULTURAL UNIVERSITY	江西农业大学
BRAUNSCHWEIG UNIVERSITY OF TECHNOLOGY	布伦瑞克理工大学
BEAUMONT HOSPITAL	博蒙特医院
GHENT UNIVERSITY	根特大学
BOURNEMOUTH UNIVERSITY	伯恩茅斯大学
UNIVERSITY OF NORTHAMPTON	北安普顿大学
COLLEGE OF NATURAL RESOURCES	自然资源学院
AIR FORCE RESEARCH LABORATORY	美国空军实验室
SOUTHWEST AGRICULTURAL UNIVERSITY	西南农业大学
HANGZHOU UNIVERSITY	杭州大学
KUNMING INSTITUTE OF BOTANY	中国科学院昆明植物研究所
UNIVERSITY OF GOTHENBURG	哥德堡大学
CHINA NATIONAL PETROLEUM CORPORATION	中国石油总公司
UNIVERSITY OF HAMBURG	汉堡大学
SAN FRANCISCO STATE UNIVERSITY	旧金山州立大学
LIQUID CRYSTAL INSTITUTE	液晶研究所
BROAD INSTITUTE	博德研究所
UNIVERSITY OF NORTHERN BRITISH COLUMBIA	北不列颠哥伦比亚大学
DEAKIN UNIVERSITY	迪肯大学
WASEDA UNIVERSITY	早稻田大学
TENNESSEE TECHNOLOGICAL UNIVERSITY	田纳西理工大学
VETERINARY LABORATORIES AGENCY	兽医实验室机构
QUEENSLAND UNIVERSITY OF TECHNOLOGY	昆士兰理工大学
JEWISH HOSPITAL	犹太医院
ALNYLAM PHARMACEUTICALS	奥尼兰姆制药
ISTITUTO NAZIONALE DI FISICA NUCLEARE	马兰戈尼物理学 NUCLEARE
JOINT INSTITUTE FOR NUCLEAR RESEARCH	联合核研究研究所
CHINA EUROPE INTERNATIONAL BUSINESS SCHOOL	中欧国际商学院
THE AMERICAN COLLEGE OF FINANCIAL SERVICES	美国金融服务学院
HARBIN NORMAL UNIVERSITY	哈尔滨师范大学
UNIVERSITY OF SOUTH CHINA	华南大学
ENGLEWOOD HOSPITAL AND MEDICAL CENTER	恩格尔伍德医院和医疗中心
GODDARD SPACE FLIGHT CENTER	戈达德太空飞行中心
GEORGIA SOUTHERN UNIVERSITY	佐治亚南方大学
UNIVERSITY OF MISSISSIPPI MEDICAL CENTER	密西西比大学医学中心
TOKYO ELECTRON	东京电子
UNIVERSITY OF ST ANDREWS	圣安德鲁斯大学
MARSHALL UNIVERSITY	马歇尔大学
NORTH CAROLINA STATE UNIVERSITY	北卡罗来纳州立大学
WUHAN POLYTECHNIC UNIVERSITY	武汉理工大学
JOHNSON & JOHNSON PHARMACEUTICAL RESEARCH AND DEVELOPMENT	约翰逊和约翰逊制药研究与开发
LIFE TECHNOLOGIES	生命技术
CHONGQING TECHNOLOGY AND BUSINESS UNIVERSITY	重庆工商大学
SWISS FEDERAL INSTITUTE OF AQUATIC SCIENCE AND TECHNOLOGY	瑞士联邦水产科学与技术研究所
MONTREAL CHILDREN'S HOSPITAL	蒙特利尔儿童医院
WEST PHARMACEUTICAL SERVICES	西医药服务
SUN YAT-SEN UNIVERSITY OF MEDICAL SCIENCES	中山医科大学
EPIGENOMICS AG	EPIGENOMICS 股份公司
UNIVERSITY CORPORATION FOR ATMOSPHERIC RESEARCH	大学大气研究公司
MITSUBISHI	三菱
INDIAN INSTITUTE OF TECHNOLOGY BOMBAY	孟买印度技术研究所
UNIVERSITY OF MAINE	缅因州大学
COLORADO SCHOOL OF MINES	科罗拉多矿业学院
UNIVERSITY MEDICAL CENTER NEW ORLEANS	新奥尔良大学医学中心
UNIVERSITY OF TEXAS SYSTEM	德克萨斯大学系统
DUPONT CENTRAL RESEARCH	杜邦中心研究
GLASGOW CALEDONIAN UNIVERSITY	格拉斯哥加里东大学
PUBLIC HEALTH AGENCY OF CANADA	加拿大公共卫生机构
HEBEI UNIVERSITY OF TECHNOLOGY	河北工业大学
WESTERN DIGITAL	西部数据
RUHR UNIVERSITY BOCHUM	波鸿鲁尔大学
FLORIDA INSTITUTE OF TECHNOLOGY	佛罗里达理工学院
AGERE SYSTEMS	杰尔系统
CHIBA UNIVERSITY	千叶大学
CALIFORNIA PACIFIC MEDICAL CENTER	加州太平洋医疗中心
FIRST AFFILIATED HOSPITAL OF WENZHOU MEDICAL UNIVERSITY	温州医科大学第一附属医院
MONSANTO	孟山都公司
BANGOR UNIVERSITY	班戈大学
ROWAN UNIVERSITY	罗文大学
ARIAD PHARMACEUTICALS, INC.	阿瑞雅德制药公司
SYNOPSYS	SYNOPSYS
CREE INC.	克里科技公司
MINISTRY OF SCIENCE AND TECHNOLOGY	科技部
UNIVERSITY HOSPITALS OF CLEVELAND	克利夫兰大学医院
POPULATION HEALTH RESEARCH INSTITUTE	人口健康研究所
UNIVERSITY OF GRAZ	格拉茨大学
GANSU AGRICULTURAL UNIVERSITY	甘肃农业大学
SOUTHWEST PETROLEUM UNIVERSITY	西南石油大学
BEIJING UNIVERSITY OF CHINESE MEDICINE	北京中医药大学
SRA INTERNATIONAL	国际
UNIVERSITY OF WINDSOR	温莎大学
ONTARIO MINISTRY OF TRANSPORTATION	安大略交通部
CENTRAL UNIVERSITY, INDIA	印度中央大学
WASTE MANAGEMENT, INC	废物管理公司
TOKYO MEDICAL AND DENTAL UNIVERSITY	东京医科牙科大学
RESEARCH INSTITUTE OF MOLECULAR PATHOLOGY	分子病理学研究院
TOKYO UNIVERSITY OF SCIENCE	东京科学大学
DOSHISHA UNIVERSITY	同志社大学
VRIJE UNIVERSITEIT BRUSSEL	布鲁塞尔自由大学
CHINESE MINISTRY OF AGRICULTURE	中国农业部
CENTRE HOSPITALIER UNIVERSITAIRE DE GRENOBLE	格勒诺布尔中心医院
JOSEPH FOURIER UNIVERSITY	约瑟夫傅里叶大学
SHANGHAI OCEAN UNIVERSITY	上海海洋大学
TECHNISCHE HOCHSCHULE	工业大学音乐学院
SANDISK	闪迪
CINCINNATI CHILDREN'S HOSPITAL MEDICAL CENTER	辛辛那提儿童医院医疗中心
UNIVERSITY OF SOUTH DAKOTA	南达科他州大学
OCEAN DRILLING PROGRAM	海洋钻探项目
SALIX PHARMACEUTICALS	柳杉制药
EASTERN VIRGINIA MEDICAL SCHOOL	东区弗吉尼亚医科大学
RWTH AACHEN UNIVERSITY	亚琛亚琛大学
WELLCOME TRUST CENTRE FOR CELL-MATRIX RESEARCH	康信细胞基质研究信托中心
HYPERTHERM	海宝
RIGSHOSPITALET	RIGSHOSPITALET
OSAKA MEDICAL COLLEGE	大阪医科大学
UNIVERSITY OF SALFORD	索尔福大学
UNIVERSITY OF NATURAL RESOURCES AND LIFE SCIENCES, VIENNA	维也纳自然资源与生命科学大学
TIANJIN UNIVERSITY OF TECHNOLOGY	天津理工大学
UNIVERSITY OF TURIN	都灵大学
RAGON INSTITUTE OF MGH, MIT AND HARVARD	麻省理工学院和哈佛大学拉贡研究所
STATE UNIVERSITY OF NEW YORK UPSTATE MEDICAL UNIVERSITY	纽约州立大学北部医科大学
MEDICAL RESEARCH COUNCIL	医学研究委员会
POLAROID CORPORATION	宝丽来公司
BOSE CORPORATION	博士公司
VIRGINIA COMMONWEALTH UNIVERSITY	弗吉尼亚联邦大学
BOEING PHANTOM WORKS	波音幻影作品
ANSCHUTZ MEDICAL CAMPUS	安舒茨医疗校区
MONTCLAIR STATE UNIVERSITY	蒙特克莱尔州立大学
SICHUAN NORMAL UNIVERSITY	四川师范大学
NORTH EAST UNIVERSITY	东北大学
HAMBURG UNIVERSITY OF TECHNOLOGY	汉堡理工大学
GERMAN RESEARCH CENTRE FOR ARTIFICIAL INTELLIGENCE	德国人工智能研究中心
COVANCE	科文斯
UNIVERSITY OF ALASKA FAIRBANKS	阿拉斯加大学费尔班克斯分校
NORTHEAST FORESTRY UNIVERSITY	东北林业大学
MYONGJI UNIVERSITY	明知大学
NOTTINGHAM TRENT UNIVERSITY	诺丁汉特伦大学
ALFRED HOSPITAL	阿尔弗雷德医院
SUN MICROSYSTEMS	太阳微计算机系统
UCL INSTITUTE OF OPHTHALMOLOGY	伦敦大学科学研究院
HELEN WILLS NEUROSCIENCE INSTITUTE	海伦遗嘱神经科学研究所
SLIPPERY ROCK UNIVERSITY OF PENNSYLVANIA	宾夕法尼亚滑岩大学
UNIVERSITY OF BASEL	巴塞尔大学
ZHEJIANG OCEAN UNIVERSITY	浙江海洋大学
FUJIAN UNIVERSITY OF TRADITIONAL CHINESE MEDICINE	福建中医药大学
CALIFORNIA NATIONAL PRIMATE RESEARCH CENTER	加州国家灵长类研究中心
HEALTH SCIENCES CENTRE	健康科学中心
WESTERN MICHIGAN UNIVERSITY	西密歇根大学
INSTITUTE FOR GEOSCIENCES AND NATURAL RESOURCES	地球科学与自然资源研究所
EDISON WELDING INSTITUTE	爱迪生焊接研究所
THE CENTRE FOR APPLIED GENOMICS	应用基因组学中心
NATIONAL INSTITUTE FOR OCCUPATIONAL SAFETY AND HEALTH	国家职业安全与健康研究所
AGRICULTURAL UNIVERSITY OF HEBEI	河北农业大学
CHANGCHUN UNIVERSITY	长春大学
JAPAN INTERNATIONAL COOPERATION AGENCY	日本国际合作署
WALTER AND ELIZA HALL INSTITUTE OF MEDICAL RESEARCH	沃尔特和伊丽莎医学研究所
ABERYSTWYTH UNIVERSITY	阿伯里斯特威斯大学
LSU HEALTH SCIENCES CENTER SHREVEPORT	LSU 健康科学中心什里夫波特
GUANGZHOU HIGHER EDUCATION MEGA CENTER	广州高等教育超级中心
CHINA GEOLOGICAL SURVEY	中国地质调查
BT GROUP	英国电信集团
AMHERST COLLEGE	阿默斯特学院
GUANGDONG MEDICAL COLLEGE	广东医科大学
HELSINKI UNIVERSITY OF TECHNOLOGY	赫尔辛基理工大学
MELLANOX TECHNOLOGIES	MELLANOX 技术
NATIONAL ILAN UNIVERSITY	国立宜兰大学
LIAONING TECHNICAL UNIVERSITY	辽宁工程技术大学
JOHN INNES CENTRE	约翰 INNES 中心
INDIAN INSTITUTE OF SCIENCE	印度科学研究院
FEDERAL RESERVE SYSTEM	联邦储备系统
OSAKA CITY UNIVERSITY	大阪城市大学
UNIVERSITY OF COLORADO DENVER	科罗拉多大学丹佛分校
QATAR COMPUTING RESEARCH INSTITUTE	卡塔尔计算研究所
INTERNATIONAL INSTITUTE OF MINNESOTA	明尼苏达国际研究所
CENTER FOR EXCELLENCE IN EDUCATION	教育卓越中心
UNITED STATES INTERNATIONAL TRADE COMMISSION	美国国际贸易委员会
PUSAN NATIONAL UNIVERSITY	釜山国立大学
GYEONGSANG NATIONAL UNIVERSITY	庆尚国立大学
KOREA ELECTROTECHNOLOGY RESEARCH INSTITUTE	韩国电工技术研究所
STATE ADMINISTRATION OF WORK SAFETY	国家安全生产总局
MEMORIAL HOSPITAL OF SOUTH BEND	南弯纪念医院
UNIVERSITY OF WEST GEORGIA	西乔治亚大学
FINISAR	FINISAR
CHINA UNICOM	中国联通
LDS HOSPITAL	LDS 医院
BLAISE PASCAL UNIVERSITY	帕斯卡大学
HUNGARIAN ACADEMY OF SCIENCES	匈牙利科学院
MCAFEE	Mcafee
MINISTRY OF CONSTRUCTION	建设部
PROVIDENCE COLLEGE	普罗维登斯学院
WARSAW UNIVERSITY OF TECHNOLOGY	华沙理工大学
CHILDREN'S HOSPITAL OAKLAND RESEARCH INSTITUTE	奥克兰儿童医院研究所
DALIAN OCEAN UNIVERSITY	大连海洋大学
DALIAN NATIONALITIES UNIVERSITY	大连民族大学
SHIPPENSBURG UNIVERSITY OF PENNSYLVANIA	宾夕法尼亚州希彭兹堡大学
KAGAWA UNIVERSITY	香川大学
TZU CHI FOUNDATION	慈济基金会
CHONNAM NATIONAL UNIVERSITY	全南大学
EASTERN MICHIGAN UNIVERSITY	东密歇根大学
WAKAYAMA MEDICAL UNIVERSITY	和歌山医科大学
TENSILICA	泰思
GEORGIA INSTITUTE OF TECHNOLOGY COLLEGE OF COMPUTING	佐治亚理工大学计算机学院
DUBLIN CITY UNIVERSITY	都柏林城市大学
SEMICONDUCTOR MANUFACTURING INTERNATIONAL CORPORATION	半导体制造国际公司
BEIJING INSTITUTE OF CLOTHING TECHNOLOGY	北京服装技术研究所
CHRISTIANA CARE HEALTH SYSTEM	卡尔斯特恩保健系统
UNIVERSITY OF GIESSEN	吉森大学
UNIVERSITY OF MIYAZAKI	宫崎大学
MANCHESTER METROPOLITAN UNIVERSITY	曼彻斯特大都会大学
MAXLINEAR	MAXLINEAR
NATIONAL CENTER FOR GENOME RESOURCES	国家基因组资源中心
SAMSUNG	三星
SIEMENS ENERGY SECTOR	西门子能源行业
RTI INTERNATIONAL	RTI 国际
IDIAP RESEARCH INSTITUTE	IDIAP 研究院
TECHNOLOGY COLLEGE	技术学院
HUAIHAI INSTITUTE OF TECHNOLOGY	淮海理工学院
RIKEN BRAIN SCIENCE INSTITUTE	理研脑科学研究所
JIANGXI NORMAL UNIVERSITY	江西师范大学
UNIVERSITY OF TASMANIA	塔斯马尼亚大学
NATIONAL KAOHSIUNG UNIVERSITY OF APPLIED SCIENCES	国立高雄应用科学大学
UNIVERSITY OF EASTERN FINLAND	芬兰东部大学
ZUNYI MEDICAL COLLEGE	遵义医科大学
VIROPHARMA	VIROPHARMA
QINGHAI UNIVERSITY	青海大学
UNIVERSITY OF SPLIT	斯普利特大学
YAMAGATA UNIVERSITY	山形大学
UNIVERSITY OF SOUTH ALABAMA	南阿拉巴马大学
SHIRE PLC	希尔制药集团
NATIONAL CHIAYI UNIVERSITY	国立嘉义大学
CAMBRIDGE HEALTH ALLIANCE	剑桥健康联盟
HARBIN INSTITUTE OF TECHNOLOGY SHENZHEN GRADUATE SCHOOL	哈尔滨理工大学深圳研究生院
CENTRAL TAIWAN UNIVERSITY OF SCIENCE AND TECHNOLOGY	中台科技大学
NINGBO INSTITUTE OF TECHNOLOGY, ZHEJIANG UNIVERSITY	浙江大学宁波理工学院
KYUSHU INSTITUTE OF TECHNOLOGY	九州理工学院
KOCHI UNIVERSITY OF TECHNOLOGY	高知理工大学
CALIFORNIA STATE UNIVERSITY, FULLERTON	加州州立大学, 富丽敦
UNIVERSITY OF LUXEMBOURG	卢森堡大学
LINK?PING UNIVERSITY	林雪平大学
NEW ZEALAND INSTITUTE FOR CROP AND FOOD RESEARCH	新西兰作物和食品研究研究所
NATIONAL CHI NAN UNIVERSITY	国立暨南国际大学
WOODS HOLE OCEANOGRAPHIC INSTITUTION	伍兹洞海洋学机构
INSTITUT NATIONAL DE LA RECHERCHE SCIENTIFIQUE	国家德拉谜科学研究
TRINITY COLLEGE	三位一体学院
UNIVERSITY OF CINCINNATI ACADEMIC HEALTH CENTER	辛辛那提大学学术健康中心
ZHEJIANG GONGSHANG UNIVERSITY	浙江工商大学
BURTON SNOWBOARDS	伯顿滑雪板
LIVERPOOL SCHOOL OF TROPICAL MEDICINE	利物浦热带医学学院
UNIVERSITY OF CONNECTICUT HEALTH CENTER	康涅狄格大学健康中心
BROADCOM	博通
CANCER RESEARCH INSTITUTE	癌症研究所
GENERAL ATOMICS	原子将军
OSLO UNIVERSITY HOSPITAL	奥斯陆大学医院
RUSH UNIVERSITY MEDICAL CENTER	拉什大学医疗中心
ADOBE SYSTEMS	ADOBE 系统
FUJI XEROX	富士施乐
UNIVERSITY OF ULM	乌尔姆大学
AMERICAN PETROLEUM INSTITUTE	美国石油研究所
MONTREAL GENERAL HOSPITAL	蒙特利尔综合医院
BUCK INSTITUTE FOR RESEARCH ON AGING	巴克老龄化研究研究所
NORTH SICHUAN MEDICAL COLLEGE	北川医科大学
CHONGQING THREE GORGES UNIVERSITY	重庆三峡学院
WANNAN MEDICAL COLLEGE	皖南医科大学
UNIVERSITY OF NORTH TEXAS HEALTH SCIENCE CENTER	北德克萨斯大学健康科学中心
LSI CORPORATION	LSI 公司
SEATTLE CHILDREN'S	西雅图儿童
SETON HALL UNIVERSITY	西东大学
ASTRAZENECA	阿斯利康
UNIVERSITY OF PERUGIA	佩鲁贾大学
UNIVERSITY OF POTSDAM	波茨坦大学
NEC CORPORATION OF AMERICA	美国 NEC 公司
BNP PARIBAS	法国巴黎银行
SHANGHAI INTERNATIONAL STUDIES UNIVERSITY	上海外国语大学
SHAOXING UNIVERSITY	绍兴大学
WUYI UNIVERSITY	武夷大学
ALLEGHENY GENERAL HOSPITAL	阿勒格尼综合医院
ACADEMY OF MILITARY SCIENCE	军事科学院
BEIJING UNITED FAMILY HOSPITAL	北京联合家庭医院
FUJITSU	富士通
ACADEMY OF SCIENCES OF THE CZECH REPUBLIC	捷克共和国科学院
SHRINERS HOSPITALS FOR CHILDREN	施赖纳斯儿童医院
HEBEI UNIVERSITY	河北大学
WASHINGTON STATE UNIVERSITY VANCOUVER	华盛顿州立大学温哥华分校
ENZON PHARMACEUTICALS, INC.	恩森制药公司
SHANDONG UNIVERSITY OF FINANCE AND ECONOMICS	山东财经大学
SOUTH UNIVERSITY	中南大学
ENVIRONMENTAL MOLECULAR SCIENCES LABORATORY	环境分子科学实验室
BATTELLE MEMORIAL INSTITUTE	巴特尔纪念研究所
CAPITAL UNIVERSITY	首都大学
AMERICAN MUSEUM OF NATURAL HISTORY	美国自然历史博物馆
VAN ANDEL INSTITUTE	VAN 温安洛研究所
UNIVERSITY OF VIENNA	维也纳大学
UNIVERSITY OF HULL	赫尔大学
REALTEK	REALTEK
UNIVERSITY OF HAWAII	夏威夷大学
CALIFORNIA DEPARTMENT OF PUBLIC HEALTH	加州公共卫生局
CHANG JUNG CHRISTIAN UNIVERSITY	长荣基督教大学
ONTARIO INSTITUTE FOR CANCER RESEARCH	安大略省癌症研究所
NATIONAL INSTITUTE OF INFORMATION AND COMMUNICATIONS TECHNOLOGY	国家信息和通信技术研究所
HUNAN UNIVERSITY OF TRADITIONAL CHINESE MEDICINE	湖南中医药大学
SAARLAND UNIVERSITY	萨尔大学
ROSIE HOSPITAL	罗西医院
CHENGDU UNIVERSITY OF TRADITIONAL CHINESE MEDICINE	成都中医药大学
SIEMENS	西门子
CELGENE	新基
OKAYAMA UNIVERSITY OF SCIENCE	冈山科学大学
WESTERN CAROLINA UNIVERSITY	西卡罗莱纳大学
UNIVERSITY OF LILLE	里尔大学
AALTO UNIVERSITY	阿尔托大学
UNIVERSITY OF STUTTGART	斯图加特大学
UNIVERSITY OF OULU	奥卢大学
UNIVERSITY MEDICAL CENTER	大学医疗中心
NXP SEMICONDUCTORS	恩智浦半导体
CHINA MOBILE RESEARCH INSTITUTE	中国移动研究所
PALL CORPORATION	波尔公司
SEQUENOM, INC.	SEQUENOM 公司
UNIVERSITY OF TEXAS AT BROWNSVILLE	德克萨斯大学布朗斯维尔分校
HAMPTON UNIVERSITY	汉普顿大学
RYERSON UNIVERSITY	瑞尔森大学
GUANGZHOU UNIVERSITY OF CHINESE MEDICINE	广州中医药大学
STATE GRID CORPORATION OF CHINA	中国国家电网公司
MOUNT SINAI ST. LUKE'S AND MOUNT SINAI ROOSEVELT	西奈山圣卢克和西奈山罗斯福
UNIVERSITY OF CANBERRA	堪培拉大学
UNIVERSITY OF MONTPELLIER	蒙彼利埃大学
CHINESE ACADEMY OF ENGINEERING	中国工程学院
UNITED AIRLINES	联合航空公司
LANGLEY RESEARCH CENTER	兰利研究中心
HUBEI UNIVERSITY OF MEDICINE	湖北医科大学
UNITED KINGDOM MINISTRY OF JUSTICE	联合王国司法部
NATIONAL PINGTUNG UNIVERSITY OF SCIENCE AND TECHNOLOGY	国立屏东科技大学
UNIFORMED SERVICES UNIVERSITY OF THE HEALTH SCIENCES	健康科学制服服务大学
CHEMNITZ UNIVERSITY OF TECHNOLOGY	开姆尼茨理工大学
NEW MEXICO INSTITUTE OF MINING AND TECHNOLOGY	新墨西哥矿业和技术研究所
UNIVERSITY OF COLORADO HOSPITAL	科罗拉多大学医院
AREVA	阿海珐
FEDERAL RESERVE BANK OF ST. LOUIS	圣路易斯联邦储备银行
UNIVERSITY OF MISSOURI–KANSAS CITY	密苏里大学堪萨斯分校
CANADIAN FOREST SERVICE	加拿大森林事务处
UNIVERSITY OF LIMERICK	利默里克大学
JIMEI UNIVERSITY	集美大学
INTERNATIONAL MONETARY FUND	国际货币基金组织
ACADEMIC CENTER FOR DENTISTRY AMSTERDAM	阿姆斯特丹牙科学术中心
HEART AND STROKE FOUNDATION OF CANADA	加拿大心脏和中风基金会
UNIVERSITY OF DAYTON RESEARCH INSTITUTE	代顿大学研究所
SCIENCE COLLEGE	科学学院
INTERNATIONAL CENTRE FOR GENETIC ENGINEERING AND BIOTECHNOLOGY	国际遗传工程和生物技术中心
MIE UNIVERSITY	三重县大学
UNIVERSITY OF NORTH CAROLINA AT GREENSBORO	北卡罗来纳大学格林斯伯勒分校
GULF COAST REGIONAL BLOOD CENTER	海湾沿岸区域血液中心
UNIVERSITY OF NORTHERN IOWA	北爱荷华州大学
CANADIAN LIGHT SOURCE	加拿大光源
VMWARE	Vmware
PRINCESS MARGARET CANCER CENTRE	玛格丽特公主癌症中心
TUFTS MEDICAL CENTER	塔夫茨医疗中心
ASHLAND INC.	阿什兰公司
LANDCARE RESEARCH	土地保护研究
LOUISIANA STATE UNIVERSITY SYSTEM	路易斯安那州立大学系统
ZHAOQING UNIVERSITY	肇庆大学
AALBORG UNIVERSITY	奥尔堡大学
SOUTHWEST UNIVERSITY OF SCIENCE AND TECHNOLOGY	西南科技大学
GANNON UNIVERSITY	加努恩大学
CHUNG YUAN CHRISTIAN UNIVERSITY	中原基督教大学
SAMSUNG MEDICAL CENTER	三星医疗中心
AUBURN UNIVERSITY	奥本大学
JOHN L. SCOTT	约翰 L. 斯科特
EUROPEAN ATOMIC ENERGY COMMUNITY	欧洲原子能共同体
UNIVERSITY OF ROCHESTER MEDICAL CENTER	罗切斯特大学医学中心
AMERICAN COLLEGE OF SURGEONS	美国外科医生学院
WORCESTER POLYTECHNIC INSTITUTE	伍斯特理工学院
FOLKWANG UNIVERSITY OF THE ARTS	富特旺根艺术大学
UNIVERSITY OF WEST LONDON	西伦敦大学
RAND CORPORATION	兰特公司
UNIVERSITY OF BEDFORDSHIRE	贝德福德郡大学
NEW YORK BLOOD CENTER	纽约血液中心
HUAIBEI NORMAL UNIVERSITY	淮北师范大学
UNIVERSITY OF AGDER	阿哥德大学
TOSHIBA	东芝
ALBERT EINSTEIN MEDICAL CENTER	阿尔伯特·爱因斯坦医疗中心
KENT STATE UNIVERSITY	肯特州立大学
ST. PAUL'S HOSPITAL	圣保罗医院
GARVAN INSTITUTE OF MEDICAL RESEARCH	加文医学医学研究所
SCHLUMBERGER	斯伦贝谢
CALIPER LIFE SCIENCES	卡尺生命科学
MICROSOFT RESEARCH ASIA (CHINA)	微软研究亚洲 (中国)
SOFTWARE ENGINEERING INSTITUTE	软件工程研究所
TOYOTA TECHNOLOGICAL INSTITUTE	丰田技术研究院
UNIVERSITY OF BERN	伯尔尼大学
VIENNA UNIVERSITY OF TECHNOLOGY	维也纳理工大学
UNIVERSITY OF ROSTOCK	罗斯托克大学
TUSKEGEE UNIVERSITY	塔斯基吉大学
SHAANXI UNIVERSITY OF TECHNOLOGY	陕西工业大学
GENETICS INSTITUTE, INC.	遗传学研究所公司
SANTA CLARA UNIVERSITY	圣克拉拉大学
GIFU PHARMACEUTICAL UNIVERSITY	岐阜药科大学
SCIENCES PO	巴黎政治大学
SOJO UNIVERSITY	崇城大学
TAIPEI MEDICAL UNIVERSITY	台北医科大学
VASSAR COLLEGE	瓦萨学院
APPLIED SCIENCE PRIVATE UNIVERSITY	应用科学私立大学
CERES, INC.	谷神星公司
ROCKY MOUNTAIN LABORATORIES	洛基山脉实验室
GLION INSTITUTE OF HIGHER EDUCATION	格里昂高等教育学院
DANA CORPORATION	达纳公司
UNIVERSITY OF LISBON	里斯本大学
BEIJING TONGREN HOSPITAL	北京同仁医院
SOUTHERN CALIFORNIA GAS COMPANY	南加州煤气公司
LULE? UNIVERSITY OF TECHNOLOGY	律勒欧萨摩斯?技术大学
CHUNGBUK NATIONAL UNIVERSITY	忠北国立大学
HEBEI UNIVERSITY OF SCIENCE AND TECHNOLOGY	河北科技大学
THOMAS JEFFERSON UNIVERSITY HOSPITAL	托马斯·杰斐逊大学医院
NATIONAL YANG-MING UNIVERSITY	国立阳明大学
KUWAIT INSTITUTE FOR SCIENTIFIC RESEARCH	科威特科学研究所
KAO CORPORATION	花王公司
WISTAR INSTITUTE	威斯达研究所
MINISTRY OF ENVIRONMENTAL PROTECTION OF THE PEOPLE'S REPUBLIC OF CHINA	中华人民共和国环境保护部
ACCENTURE	埃森哲
MCGILL UNIVERSITY HEALTH CENTRE	麦吉尔大学健康中心
MENTAL HEALTH RESEARCH INSTITUTE	心理健康研究所
UTSUNOMIYA UNIVERSITY	宇都宫大学
ARKANSAS STATE UNIVERSITY	阿肯色州立大学
NOKIA NETWORKS	诺基亚网络
INNER MONGOLIA UNIVERSITY	内蒙古大学
CALIFORNIA INSTITUTE FOR QUANTITATIVE BIOSCIENCES	加利福尼亚定量生物科学研究所
BEIJING INFORMATION SCIENCE & TECHNOLOGY UNIVERSITY	北京信息科技大学
UNIVERSITY OF PRETORIA	比勒陀利亚大学
WILLIAM PATERSON UNIVERSITY	威廉帕特森大学
YOUNGSTOWN STATE UNIVERSITY	州立扬斯敦大学
KINDAI UNIVERSITY	近代大学
COLLEGE OF WILLIAM & MARY	威廉玛丽学院
SOUTH CAROLINA DEPARTMENT OF HEALTH AND ENVIRONMENTAL CONTROL	南卡罗来纳州卫生与环境控制部
JIANGHAN UNIVERSITY	江汉大学
UNIVERSITY OF LOUISIANA AT LAFAYETTE	路易斯安那州立大学拉斐特分校
EXELIXIS	EXELIXIS
TOKAI UNIVERSITY	东海大学
ASTRA	阿斯特拉
ANALYSIS GROUP	分析组
UCL INSTITUTE OF NEUROLOGY	加州大学洛杉矶分校神经病学研究所
EBAY	易趣
TIANJIN UNIVERSITY OF COMMERCE	天津商业大学
DELPHI AUTOMOTIVE	德尔福汽车
EPSON	爱普生
PLANT GENOME MAPPING LABORATORY	植物基因组测绘实验室
SANDIA NATIONAL LABORATORIES	桑迪亚国家实验室
UNIVERSITE DE TECHNOLOGIE DE BELFORT-MONTBELIARD	贝尔福-蒙比利亚工程技术大学
INSTITUT GUSTAVE ROUSSY	古贝拉吉奥柏学院
BASCOM PALMER EYE INSTITUTE	巴斯科姆帕尔默眼科研究所
APRIL	四月
HELMHOLTZ-ZENTRUM BERLIN	亥姆霍兹-柏林
MEDIATEK	联发科
BILKENT UNIVERSITY	比尔肯特大学
INCYTE	INCYTE
MINISTRY OF RAILWAYS	铁道部
UNIVERSITY OF SCIENCE AND TECHNOLOGY, LIAONING	辽宁科技大学
PENN STATE COLLEGE OF COMMUNICATIONS	宾夕法尼亚州立通信学院
VICTORIA UNIVERSITY OF WELLINGTON	惠灵顿维多利亚大学
SHANDONG JIANZHU UNIVERSITY	山东建筑大学
NATIONAL INSTITUTE OF EDUCATION	国立教育学院
MAINE MEDICAL CENTER	缅因州医疗中心
UNIVERSITY OF TOYAMA	富山大学
UNIVERSITY OF S?O PAULO	圣保罗大学
TYNDALL NATIONAL INSTITUTE	廷德尔空军基地国家研究所
EATON CORPORATION	伊顿公司
AMERICAN CYANAMID	美国氰胺
CHANGSHU INSTITUTE OF TECHNOLOGY	常熟理工学院
XINYANG NORMAL UNIVERSITY	信阳师范大学
MEDSTAR WASHINGTON HOSPITAL CENTER	MEDSTAR 华盛顿医院中心
UNIVERSITY OF DüSSELDORF	杜塞尔多夫大学
SOLARMER ENERGY, INC.	SOLARMER 能源公司
SYSTEMS RESEARCH INSTITUTE	系统研究所
SOCIETY OF ACTUARIES	精算师学会
TEL AVIV UNIVERSITY	特拉维夫大学
TELLABS	TELLABS
COMSATS INSTITUTE OF INFORMATION TECHNOLOGY	学院信息技术研究所
GLOBAL ALLIANCE IN MANAGEMENT EDUCATION	管理教育全球联盟
FUGRO	辉固
YAMAGUCHI UNIVERSITY	山口大学
GEOLOGICAL MUSEUM	地质博物馆
ARISTOTLE UNIVERSITY OF THESSALONIKI	塞萨洛尼基亚里士多德大学
NATIONAL INSTITUTE OF RADIOLOGICAL SCIENCES	国立放射科学研究所
COPENHAGEN UNIVERSITY HOSPITAL	哥本哈根大学医院
MASSACHUSETTS MENTAL HEALTH CENTER	马萨诸塞州心理健康中心
SHIJIAZHUANG RAILWAY INSTITUTE	石家庄铁路学院
DALI UNIVERSITY	大理大学
BAYLOR UNIVERSITY	贝勒大学
NEW YORK STATE DEPARTMENT OF HEALTH	纽约州卫生局
WADSWORTH CENTER	沃思中心
UNIVERSITY OF DAYTON	代顿大学
MISSOURI STATE UNIVERSITY	密苏里州立大学
WEST CHESTER UNIVERSITY OF PENNSYLVANIA	宾州西彻斯特大学
UNITED STATES ENVIRONMENTAL PROTECTION AGENCY	美国环境保护局
RAILWAY INSTITUTE	铁路学院
SEMEL INSTITUTE FOR NEUROSCIENCE AND HUMAN BEHAVIOR	塞梅尔神经科学与人类行为研究所
CHONGQING NORMAL UNIVERSITY	重庆师范大学
SHANXI AGRICULTURAL UNIVERSITY	山西农业大学
YONSEI UNIVERSITY	延世大学
CENTRAL UNIVERSITY OF FINANCE AND ECONOMICS	中央财经大学
LA JOLLA INSTITUTE FOR ALLERGY AND IMMUNOLOGY	拉霍亚过敏和免疫学研究所
UNIVERSITY OF GRONINGEN	格罗宁根大学
CSL BEHRING	杰特贝林公司
MESA+ INSTITUTE FOR NANOTECHNOLOGY	梅萨纳米技术研究所
QUEENS COLLEGE	皇后学院
COURANT INSTITUTE OF MATHEMATICAL SCIENCES	库朗数学科学研究院
HUSKY ENERGY	赫斯基能源
ANDREW CORPORATION	安德鲁公司
NATIONAL TAITUNG UNIVERSITY	国立台东大学
INSTITUT DE PHYSIQUE DU GLOBE DE PARIS	巴黎世界体质研究所
YUKAWA INSTITUTE FOR THEORETICAL PHYSICS	汤川理论物理研究所
AGRESEARCH	AGRESEARCH
KYOTO PHARMACEUTICAL UNIVERSITY	京都制药大学
DANKOOK UNIVERSITY	檀国大学
TONGJI MEDICAL COLLEGE	同济医科大学
INTERNATIONAL CENTRE FOR THEORETICAL PHYSICS	国际理论物理学中心
INDUSTRIAL RESEARCH INSTITUTE	工业研究所
GENERAL INSTRUMENT	通用仪器
ROCKWELL AUTOMATION	罗克韦尔自动化
ASTRON	科学
BOOZ ALLEN HAMILTON	艾伦. 汉密尔顿
IWATE UNIVERSITY	岩手大学
UNIVERSITY OF HUDDERSFIELD	哈德斯菲尔德大学
AVIATION INDUSTRY CORPORATION OF CHINA	中国航空工业公司
SCOTTISH CROP RESEARCH INSTITUTE	苏格兰作物研究所
OKLAHOMA MEDICAL RESEARCH FOUNDATION	俄克拉何马州医学研究基金会
AIX-MARSEILLE UNIVERSITY	艾克斯-马赛大学
JIANGXI UNIVERSITY OF TRADITIONAL CHINESE MEDICINE	江西中医药大学
GLENN RESEARCH CENTER	格伦研究中心
VERTEX PHARMACEUTICALS	顶点药物
CALIFORNIA STATE UNIVERSITY, LOS ANGELES	加州州立大学洛杉矶分校
TEIKYO HEISEI UNIVERSITY	帝京平成大学
HSIUPING UNIVERSITY OF SCIENCE AND TECHNOLOGY	HSIUPING 科技大学
JUNIOR COLLEGE	大专
REHABILITATION INSTITUTE OF CHICAGO	芝加哥康复学院
WESTERN KENTUCKY UNIVERSITY	西肯塔基大学
CIVIL AVIATION UNIVERSITY OF CHINA	中国民用航空大学
NATIONAL ACADEMY OF SCIENCES OF UKRAINE	乌克兰国家科学院
OITA UNIVERSITY	大分大学
IMPAX LABORATORIES	IMPAX 实验室
UNIVERSITY OF PADUA	帕多瓦大学
COLUMBIA COLLEGE	哥伦比亚学院
LUDWIG MAXIMILIAN UNIVERSITY OF MUNICH	慕尼黑大学
ALBERTA HEALTH SERVICES	艾伯塔省卫生服务
PURPLE MOUNTAIN OBSERVATORY	紫山天文台
JET PROPULSION LABORATORY	喷气推进实验室
ITRON	埃创
INTERNATIONAL SCHOOL FOR ADVANCED STUDIES	国际高级研究学校
UNIVERSITY OF BREMEN	不来梅大学
QIMR BERGHOFER MEDICAL RESEARCH INSTITUTE	QIMR BERGHOFER 医学研究院
COLLEGE OF INDUSTRIAL TECHNOLOGY	工业技术学院
CHINA TELECOM	中国电信
BABRAHAM INSTITUTE	BABRAHAM 研究所
EXA CORPORATION	公司
MOLECULAR SCIENCES INSTITUTE	分子科学研究所
PIERRE-AND-MARIE-CURIE UNIVERSITY	皮埃尔和玛丽-居里夫人大学
MARSHALL SPACE FLIGHT CENTER	马歇尔太空飞行中心
LEIPZIG UNIVERSITY	莱比锡大学
UNIVERSITY COLLEGE DUBLIN	都柏林大学学院
BROCK UNIVERSITY	布洛克大学
TOYOHASHI UNIVERSITY OF TECHNOLOGY	丰桥理工大学
SAGA UNIVERSITY	佐贺大学
UNIVERSITY OF TOKUSHIMA	德岛大学
UTRECHT UNIVERSITY	乌得勒支大学
ISTITUTO ITALIANO DI TECNOLOGIA	马兰戈尼意大利迪意大利
PUBLIC HEALTH RESEARCH INSTITUTE	公共卫生研究所
MOLECULAR PROBES	分子探针
KYUNGPOOK NATIONAL UNIVERSITY	庆北大学国立大学
THE AEROSPACE CORPORATION	航空航天公司
CLARKSON COLLEGE	克拉克学院
GUANGDONG PHARMACEUTICAL UNIVERSITY	广东医药大学
ENI	埃尼
RIO TINTO GROUP	力拓集团
UNIVERSITY OF CAEN LOWER NORMANDY	卡昂大学下诺曼底分校
UNIVERSITY OF ROUEN	鲁昂大学
HALOZYME THERAPEUTICS	郝马克疗法
CHINA UNIVERSITY OF TECHNOLOGY	中国理工大学
FRITZ HABER INSTITUTE OF THE MAX PLANCK SOCIETY	马克斯-普朗克学会哈伯研究所
WORLD HEALTH ORGANIZATION	世界卫生组织
LIBIN CARDIOVASCULAR INSTITUTE OF ALBERTA	张利宾心血管研究所
SCOTTISH ENVIRONMENT PROTECTION AGENCY	苏格兰环境保护局
ITER	Iter
ANHUI AGRICULTURAL UNIVERSITY	安徽农业大学
ZHEJIANG UNIVERSITY OF SCIENCE AND TECHNOLOGY	浙江科技大学
OFFICE OF TECHNOLOGY TRANSFER	技术转让办公室
DELAWARE BIOTECHNOLOGY INSTITUTE	特拉华州生物技术研究所
BROOKHAVEN COLLEGE	布鲁克黑文学院
CAS-MPG PARTNER INSTITUTE FOR COMPUTATIONAL BIOLOGY	CAS-MPG 计算生物学合作伙伴研究所
COLLEGE OF HEALTH SCIENCES, BAHRAIN	巴林健康科学学院
NEW YORK CITY DEPARTMENT OF HEALTH AND MENTAL HYGIENE	纽约市卫生和精神卫生司
AIRLANGGA UNIVERSITY	艾雅蓝加大学
CALIFORNIA DEPARTMENT OF TRANSPORTATION	加利福尼亚交通运输部
IMEC	IMEC
PAUL SCHERRER INSTITUTE	保罗谢瑞研究所
NATIONAL PRESTO INDUSTRIES	全国普雷斯托工业公司
UNIVERSITY OF BAYREUTH	拜罗伊特大学
MEDIMMUNE	MEDIMMUNE
